//MAP CONVERTED BY dmm2tgm.py THIS HEADER COMMENT PREVENTS RECONVERSION, DO NOT REMOVE
"a" = (
/obj/machinery/power/terminal{
	dir = 8
	},
/obj/structure/cable{
	icon_state = "0-4"
	},
/turf/open/floor/pod,
/area/ship/bridge)
"b" = (
/obj/structure/cable{
	icon_state = "0-4"
	},
/obj/machinery/power/port_gen/pacman,
/obj/structure/window/reinforced/spawner,
/obj/structure/window/reinforced/spawner{
	dir = 8
	},
/obj/item/wrench,
/turf/open/floor/pod,
/area/ship/bridge)
"c" = (
/turf/template_noop,
/area/template_noop)
"f" = (
/obj/machinery/power/apc/auto_name/directional/north,
/obj/structure/cable{
	icon_state = "0-2"
	},
/obj/structure/cable{
	icon_state = "0-8"
	},
/obj/structure/chair/comfy/shuttle{
	dir = 4
	},
/turf/open/floor/pod,
/area/ship/bridge)
"g" = (
/obj/structure/window/reinforced/spawner{
	dir = 1
	},
/obj/structure/fans/tiny,
/obj/machinery/door/window{
	dir = 8
	},
/obj/machinery/door/window/eastright,
/obj/docking_port/mobile{
	can_move_docking_ports = 1;
	dir = 4;
	launch_status = 0;
	port_direction = 2;
	preferred_direction = 4
	},
/turf/open/floor/pod,
/area/ship/bridge)
"i" = (
/obj/structure/cable{
	icon_state = "1-8"
	},
/obj/machinery/holopad/emergency,
/turf/open/floor/pod,
/area/ship/bridge)
"p" = (
/obj/machinery/computer/helm{
	dir = 8
	},
/obj/structure/window/reinforced/spawner{
	dir = 4
	},
/turf/open/floor/pod,
/area/ship/bridge)
"s" = (
/obj/structure/cable{
	icon_state = "4-8"
	},
/obj/machinery/light_switch{
	pixel_x = -13;
	pixel_y = 23
	},
/obj/machinery/light/small/directional/north,
/turf/open/floor/pod,
/area/ship/bridge)
"u" = (
/obj/structure/window/reinforced/spawner{
	dir = 4
	},
/turf/open/floor/pod,
/area/ship/bridge)
"v" = (
/turf/closed/wall,
/area/ship/bridge)
"z" = (
/obj/machinery/cryopod{
	dir = 1;
	density = 0
	},
/turf/open/floor/pod,
/area/ship/bridge)
"G" = (
/obj/structure/cable{
	icon_state = "4-8"
	},
/obj/structure/closet/wall{
	pixel_y = 28
	},
/obj/item/stack/sheet/mineral/plasma/twenty,
/obj/item/storage/toolbox/emergency,
/obj/item/storage/firstaid/ancient,
/obj/item/storage/bag/ore,
/obj/item/storage/bag/plants,
/obj/item/stack/cable_coil/red,
/obj/item/extinguisher/mini,
/obj/item/reagent_containers/pill/charcoal,
/obj/item/reagent_containers/pill/charcoal,
/obj/item/reagent_containers/pill/charcoal,
/turf/open/floor/pod,
/area/ship/bridge)
"I" = (
/obj/machinery/light/small/directional/south,
/turf/open/floor/pod,
/area/ship/bridge)
"L" = (
/obj/machinery/power/shuttle/engine/electric/bad{
	dir = 4
	},
/obj/structure/cable{
	icon_state = "0-4"
	},
/turf/open/floor/engine/hull,
/area/ship/bridge)
"R" = (
/obj/machinery/power/smes/shuttle/micro/precharged{
	dir = 4
	},
/obj/structure/cable{
	icon_state = "0-8"
	},
/obj/structure/window/reinforced/spawner{
	dir = 8
	},
/turf/open/floor/pod,
/area/ship/bridge)
"V" = (
/turf/open/floor/pod,
/area/ship/bridge)
"Y" = (
/obj/structure/window/reinforced/spawner{
	dir = 4
	},
/obj/item/pickaxe/rusted,
/obj/item/kitchen/knife/shiv,
/obj/item/hatchet,
/obj/item/gps,
/obj/item/flashlight/lantern,
/obj/item/clothing/suit/space/fragile,
/obj/item/clothing/mask/breath,
/obj/item/clothing/head/helmet/space/fragile,
/obj/structure/rack,
/obj/item/radio,
/obj/item/reagent_containers/food/drinks/waterbottle/large,
/obj/item/reagent_containers/food/drinks/waterbottle/large,
/obj/item/reagent_containers/food/snacks/rationpack,
/obj/item/reagent_containers/food/snacks/rationpack,
/obj/item/reagent_containers/food/snacks/rationpack,
/obj/item/reagent_containers/food/snacks/rationpack,
/obj/item/clothing/gloves/color/fyellow,
/obj/item/tank/internals/oxygen,
/turf/open/floor/pod,
/area/ship/bridge)

(1,1,1) = {"
c
c
c
c
c
"}
(2,1,1) = {"
v
b
L
g
v
"}
(3,1,1) = {"
v
G
R
V
v
"}
(4,1,1) = {"
v
s
a
I
v
"}
(5,1,1) = {"
v
f
i
z
v
"}
(6,1,1) = {"
v
p
u
Y
v
"}
(7,1,1) = {"
v
c
c
c
v
"}
