//MAP CONVERTED BY dmm2tgm.py THIS HEADER COMMENT PREVENTS RECONVERSION, DO NOT REMOVE
"aU" = (
/obj/machinery/power/apc/auto_name/directional/east,
/obj/structure/cable{
	icon_state = "0-8"
	},
/obj/machinery/atmospherics/components/unary/vent_pump/on/layer4{
	dir = 8
	},
/obj/machinery/airalarm/directional/north,
/turf/open/floor/carpet/purple,
/area/ship/science)
"bj" = (
/obj/machinery/porta_turret/syndicate/energy{
	dir = 6;
	faction = list("neutral","turret")
	},
/turf/closed/wall/mineral/plastitanium,
/area/ship/bridge)
"bJ" = (
/obj/machinery/airalarm{
	dir = 4;
	pixel_x = -16
	},
/turf/open/floor/carpet/black,
/area/ship/cargo)
"ck" = (
/obj/machinery/light/directional/west,
/obj/machinery/camera/autoname{
	dir = 5
	},
/obj/structure/cable{
	icon_state = "1-2"
	},
/obj/machinery/atmospherics/components/unary/vent_pump/on/layer4{
	dir = 4
	},
/turf/open/floor/carpet/royalblack,
/area/ship/bridge)
"di" = (
/obj/machinery/power/shieldwallgen/atmos/roundstart{
	dir = 4;
	id = "acron_holofield"
	},
/obj/machinery/door/poddoor{
	id = "acron_cargo"
	},
/obj/structure/cable{
	icon_state = "0-4"
	},
/turf/open/floor/carpet/black,
/area/ship/cargo)
"dK" = (
/turf/closed/wall/mineral/plastitanium,
/area/ship/cargo)
"eb" = (
/obj/machinery/power/shuttle/engine/electric{
	dir = 4
	},
/obj/structure/window/reinforced{
	dir = 8
	},
/obj/machinery/door/poddoor{
	id = "acron_eng";
	dir = 4
	},
/obj/structure/cable{
	icon_state = "0-4"
	},
/turf/open/floor/carpet/black,
/area/ship/engineering)
"eH" = (
/obj/machinery/camera/autoname,
/obj/structure/cable{
	icon_state = "4-8"
	},
/obj/machinery/atmospherics/pipe/simple/supply/hidden/layer4{
	dir = 8
	},
/obj/machinery/atmospherics/pipe/simple/scrubbers/hidden{
	dir = 8
	},
/turf/open/floor/carpet/black,
/area/ship/hallway/central)
"fm" = (
/obj/structure/cable{
	icon_state = "2-8"
	},
/obj/structure/cable{
	icon_state = "1-2"
	},
/obj/machinery/atmospherics/components/unary/vent_pump/on/layer4{
	dir = 6
	},
/turf/open/floor/mineral/titanium/yellow,
/area/ship/engineering)
"fz" = (
/obj/machinery/computer/helm{
	dir = 8
	},
/turf/open/floor/carpet/royalblack,
/area/ship/bridge)
"gs" = (
/obj/machinery/porta_turret/syndicate/energy{
	dir = 5;
	faction = list("neutral","turret")
	},
/turf/closed/wall/mineral/plastitanium,
/area/ship/bridge)
"gA" = (
/obj/structure/cable{
	icon_state = "2-8"
	},
/obj/machinery/atmospherics/pipe/simple/supply/hidden/layer4{
	dir = 8
	},
/obj/machinery/atmospherics/pipe/simple/scrubbers/hidden{
	dir = 8
	},
/turf/open/floor/carpet/royalblack,
/area/ship/bridge)
"hh" = (
/obj/machinery/light/directional/west,
/obj/machinery/camera/autoname{
	dir = 4
	},
/obj/machinery/atmospherics/components/unary/vent_scrubber/on{
	dir = 4
	},
/turf/open/floor/carpet/royalblack,
/area/ship/bridge)
"hx" = (
/obj/machinery/atmospherics/pipe/simple/scrubbers/hidden{
	dir = 10
	},
/turf/open/floor/carpet/blue,
/area/ship/medical)
"hA" = (
/obj/machinery/rnd/server,
/turf/open/floor/carpet/purple,
/area/ship/science)
"hY" = (
/obj/machinery/power/terminal{
	dir = 8
	},
/obj/structure/cable{
	icon_state = "0-2"
	},
/obj/structure/cable,
/turf/open/floor/mineral/titanium/yellow,
/area/ship/engineering)
"ig" = (
/obj/structure/cable{
	icon_state = "2-8"
	},
/obj/structure/cable{
	icon_state = "4-8"
	},
/obj/machinery/atmospherics/pipe/simple/supply/hidden/layer4{
	dir = 8
	},
/obj/machinery/atmospherics/pipe/simple/scrubbers/hidden{
	dir = 8
	},
/turf/open/floor/carpet/black,
/area/ship/cargo)
"iv" = (
/obj/structure/table/optable,
/turf/open/floor/carpet/blue,
/area/ship/medical)
"iQ" = (
/obj/structure/cable{
	icon_state = "0-4"
	},
/obj/structure/cable{
	icon_state = "2-4"
	},
/obj/machinery/door/poddoor{
	id = "acron_cargo"
	},
/obj/structure/cable{
	icon_state = "4-8"
	},
/obj/machinery/atmospherics/pipe/simple/scrubbers/hidden{
	dir = 7
	},
/turf/open/floor/carpet/black,
/area/ship/cargo)
"kB" = (
/obj/effect/spawner/structure/window/plasma/reinforced/plastitanium,
/obj/machinery/door/poddoor{
	id = "acron_external"
	},
/turf/open/floor/carpet/royalblack,
/area/ship/bridge)
"kV" = (
/obj/machinery/atmospherics/pipe/simple/supply/hidden/layer4{
	dir = 7
	},
/turf/open/floor/mineral/titanium/yellow,
/area/ship/engineering)
"mQ" = (
/obj/machinery/light_switch{
	dir = 1;
	pixel_x = 11;
	pixel_y = -16
	},
/turf/open/floor/carpet/blue,
/area/ship/medical)
"na" = (
/obj/effect/spawner/structure/window/plasma/reinforced/plastitanium,
/obj/machinery/door/poddoor{
	id = "acron_external"
	},
/turf/open/floor/carpet/black,
/area/ship/medical)
"nx" = (
/obj/machinery/light/directional/west,
/obj/machinery/rnd/production/circuit_imprinter/department/science,
/obj/machinery/atmospherics/components/unary/vent_scrubber/on{
	dir = 4
	},
/turf/open/floor/carpet/purple,
/area/ship/science)
"od" = (
/obj/structure/cable{
	icon_state = "4-8"
	},
/obj/machinery/atmospherics/pipe/simple/supply/hidden/layer4{
	dir = 8
	},
/obj/machinery/atmospherics/pipe/simple/scrubbers/hidden{
	dir = 8
	},
/turf/open/floor/carpet/black,
/area/ship/cargo)
"og" = (
/obj/effect/spawner/structure/window/plasma/reinforced/plastitanium,
/obj/machinery/door/poddoor/shutters{
	id = "Ranger_SB_maint_shut"
	},
/obj/machinery/door/poddoor{
	id = "acron_external"
	},
/turf/open/floor/carpet/royalblack,
/area/ship/bridge)
"oQ" = (
/obj/machinery/atmospherics/pipe/simple/supply/hidden/layer4{
	dir = 9
	},
/turf/open/floor/carpet/royalblack,
/area/ship/bridge)
"pG" = (
/turf/closed/wall/mineral/plastitanium,
/area/ship/engineering)
"qv" = (
/obj/effect/spawner/structure/window/plasma/reinforced/plastitanium,
/obj/machinery/door/poddoor{
	id = "acron_eng";
	dir = 4
	},
/turf/open/floor/carpet/black,
/area/ship/engineering)
"rG" = (
/obj/structure/cable{
	icon_state = "1-4"
	},
/obj/structure/cable{
	icon_state = "1-2"
	},
/obj/machinery/atmospherics/pipe/simple/supply/hidden/layer4{
	dir = 5
	},
/obj/machinery/atmospherics/pipe/simple/scrubbers/hidden{
	dir = 8
	},
/turf/open/floor/mineral/titanium/yellow,
/area/ship/engineering)
"sc" = (
/obj/machinery/atmospherics/components/unary/vent_scrubber/on{
	dir = 4
	},
/turf/open/floor/carpet/black,
/area/ship/cargo)
"sB" = (
/obj/machinery/porta_turret/syndicate/energy{
	dir = 10;
	faction = list("neutral","turret")
	},
/turf/closed/wall/mineral/plastitanium,
/area/ship/engineering)
"tt" = (
/obj/machinery/airalarm{
	dir = 4;
	pixel_x = -16
	},
/obj/machinery/cryopod{
	dir = 4
	},
/turf/open/floor/carpet/royalblack,
/area/ship/bridge)
"tA" = (
/obj/machinery/atmospherics/components/unary/vent_pump/on/layer4{
	dir = 4
	},
/turf/open/floor/carpet/black,
/area/ship/cargo)
"tB" = (
/obj/structure/table,
/obj/machinery/recharger,
/obj/machinery/light_switch{
	pixel_y = 21;
	pixel_x = -12;
	dir = 8
	},
/turf/open/floor/carpet/royalblack,
/area/ship/bridge)
"tY" = (
/obj/machinery/light_switch{
	pixel_y = 21;
	pixel_x = 8
	},
/turf/open/floor/carpet/purple,
/area/ship/science)
"vn" = (
/obj/machinery/light/directional/south,
/obj/machinery/autolathe,
/turf/open/floor/carpet/black,
/area/ship/cargo)
"vA" = (
/obj/machinery/camera/autoname{
	dir = 9
	},
/obj/machinery/button/door{
	pixel_x = 22;
	pixel_y = 10;
	name = "blast door control";
	id = "acron_cargo";
	dir = 8
	},
/obj/machinery/button/shieldwallgen{
	dir = 8;
	pixel_x = 20;
	pixel_y = -7;
	id = "acron_holofield"
	},
/turf/open/floor/carpet/black,
/area/ship/cargo)
"vC" = (
/obj/machinery/camera/autoname{
	dir = 5
	},
/obj/structure/table,
/obj/item/storage/backpack/duffelbag/med/surgery,
/obj/item/storage/firstaid/medical{
	pixel_y = 7;
	pixel_x = -2
	},
/obj/item/defibrillator/loaded,
/turf/open/floor/carpet/blue,
/area/ship/medical)
"vG" = (
/obj/machinery/power/apc/auto_name/directional/east,
/turf/open/floor/mineral/titanium/yellow,
/area/ship/engineering)
"vQ" = (
/obj/machinery/camera/autoname{
	dir = 4
	},
/obj/machinery/computer/rdconsole{
	dir = 4
	},
/turf/open/floor/carpet/purple,
/area/ship/science)
"xr" = (
/obj/structure/cable{
	icon_state = "1-2"
	},
/obj/machinery/atmospherics/pipe/manifold/scrubbers/hidden{
	dir = 4
	},
/turf/open/floor/carpet/black,
/area/ship/cargo)
"xz" = (
/obj/machinery/porta_turret/syndicate/energy{
	dir = 9;
	faction = list("neutral","turret")
	},
/turf/closed/wall/mineral/plastitanium,
/area/ship/engineering)
"yR" = (
/obj/structure/closet/wall/orange{
	dir = 6;
	pixel_y = -32;
	name = "Engineering Closet"
	},
/obj/item/storage/toolbox/mechanical,
/obj/item/multitool,
/obj/machinery/atmospherics/pipe/simple/supply/hidden/layer4{
	dir = 9
	},
/turf/open/floor/carpet/black,
/area/ship/cargo)
"zc" = (
/obj/machinery/power/shieldwallgen/atmos/roundstart{
	id = "acron_holofield";
	dir = 8
	},
/obj/structure/cable{
	icon_state = "0-8"
	},
/obj/machinery/door/poddoor{
	id = "acron_cargo"
	},
/turf/open/floor/carpet/black,
/area/ship/cargo)
"zB" = (
/obj/machinery/power/port_gen/pacman,
/obj/structure/cable,
/obj/item/stack/sheet/mineral/plasma/twenty,
/turf/open/floor/mineral/titanium/yellow,
/area/ship/engineering)
"zL" = (
/obj/machinery/power/terminal{
	dir = 8
	},
/obj/structure/cable,
/obj/structure/cable{
	icon_state = "0-2"
	},
/turf/open/floor/mineral/titanium/yellow,
/area/ship/engineering)
"zN" = (
/turf/open/floor/carpet/royalblack,
/area/ship/bridge)
"Aq" = (
/obj/machinery/power/terminal{
	dir = 8
	},
/obj/structure/cable{
	icon_state = "0-2"
	},
/turf/open/floor/mineral/titanium/yellow,
/area/ship/engineering)
"Au" = (
/obj/structure/cable{
	icon_state = "4-8"
	},
/obj/structure/cable{
	icon_state = "1-4"
	},
/obj/machinery/atmospherics/pipe/manifold4w/scrubbers/hidden,
/obj/machinery/atmospherics/pipe/manifold/supply/hidden/layer4{
	dir = 1
	},
/turf/open/floor/carpet/black,
/area/ship/cargo)
"AQ" = (
/obj/machinery/light/directional/west,
/obj/machinery/atmospherics/components/unary/vent_scrubber/on{
	dir = 4
	},
/turf/open/floor/carpet/blue,
/area/ship/medical)
"Bf" = (
/obj/machinery/door/airlock/medical{
	name = "Medical"
	},
/obj/structure/cable{
	icon_state = "1-2"
	},
/obj/machinery/atmospherics/pipe/simple/supply/hidden/layer4{
	dir = 7
	},
/obj/machinery/atmospherics/pipe/simple/scrubbers/hidden{
	dir = 7
	},
/turf/open/floor/carpet/black,
/area/ship/medical)
"Cq" = (
/obj/machinery/atmospherics/pipe/manifold/supply/hidden/layer4{
	dir = 1
	},
/turf/closed/wall/mineral/plastitanium,
/area/ship/cargo)
"CA" = (
/obj/structure/cable{
	icon_state = "2-4"
	},
/obj/machinery/atmospherics/pipe/simple/supply/hidden/layer4{
	dir = 6
	},
/obj/machinery/atmospherics/pipe/simple/scrubbers/hidden{
	dir = 7
	},
/turf/open/floor/carpet/blue,
/area/ship/medical)
"CM" = (
/obj/machinery/light/directional/north,
/turf/open/floor/carpet/black,
/area/ship/cargo)
"Dn" = (
/obj/effect/spawner/structure/window/plasma/reinforced/plastitanium,
/obj/machinery/door/poddoor/shutters{
	dir = 4
	},
/obj/machinery/door/poddoor{
	id = "acron_external"
	},
/turf/open/floor/carpet/royalblack,
/area/ship/bridge)
"Dr" = (
/obj/structure/cable{
	icon_state = "1-2"
	},
/turf/open/floor/mineral/titanium/yellow,
/area/ship/engineering)
"Ea" = (
/obj/machinery/airalarm{
	dir = 8;
	pixel_x = 16
	},
/turf/open/floor/mineral/titanium/yellow,
/area/ship/engineering)
"Ek" = (
/obj/machinery/power/smes/engineering,
/obj/structure/cable{
	icon_state = "0-4"
	},
/turf/open/floor/mineral/titanium/yellow,
/area/ship/engineering)
"EK" = (
/turf/open/floor/carpet/purple,
/area/ship/science)
"Fa" = (
/obj/machinery/rnd/production/protolathe/department/science,
/obj/machinery/atmospherics/pipe/simple/scrubbers/hidden{
	dir = 9
	},
/turf/open/floor/carpet/purple,
/area/ship/science)
"Fg" = (
/obj/machinery/camera/autoname{
	dir = 10
	},
/obj/structure/cable{
	icon_state = "4-8"
	},
/obj/machinery/atmospherics/pipe/simple/supply/hidden/layer4{
	dir = 8
	},
/obj/machinery/atmospherics/pipe/simple/scrubbers/hidden{
	dir = 8
	},
/turf/open/floor/carpet/black,
/area/ship/hallway/central)
"Gl" = (
/turf/closed/wall/mineral/plastitanium,
/area/ship/medical)
"Ht" = (
/obj/structure/cable{
	icon_state = "4-8"
	},
/obj/machinery/atmospherics/pipe/simple/supply/hidden/layer4{
	dir = 8
	},
/obj/machinery/atmospherics/pipe/simple/scrubbers/hidden{
	dir = 8
	},
/obj/machinery/door/airlock/command{
	dir = 4;
	name = "Bridge"
	},
/turf/open/floor/carpet/black,
/area/ship/bridge)
"Hw" = (
/obj/machinery/power/apc/auto_name/directional/west,
/obj/structure/cable,
/obj/machinery/mineral/ore_redemption{
	dir = 1;
	output_dir = 1
	},
/turf/open/floor/carpet/black,
/area/ship/cargo)
"HD" = (
/obj/machinery/atmospherics/pipe/simple/supply/hidden/layer4{
	dir = 10
	},
/obj/machinery/atmospherics/pipe/simple/scrubbers/hidden{
	dir = 9
	},
/turf/open/floor/carpet/royalblack,
/area/ship/bridge)
"IJ" = (
/turf/open/floor/carpet/blue,
/area/ship/medical)
"JA" = (
/obj/machinery/door/airlock/research{
	name = "Research"
	},
/obj/structure/cable{
	icon_state = "1-2"
	},
/obj/machinery/atmospherics/pipe/simple/supply/hidden/layer4,
/obj/machinery/atmospherics/pipe/simple/scrubbers/hidden{
	dir = 7
	},
/turf/open/floor/carpet/black,
/area/ship/science)
"JB" = (
/obj/machinery/power/apc/auto_name/directional/west,
/obj/structure/cable,
/turf/open/floor/carpet/royalblack,
/area/ship/bridge)
"JR" = (
/obj/effect/spawner/structure/window/plasma/reinforced/plastitanium,
/obj/machinery/door/poddoor{
	id = "acron_external"
	},
/turf/open/floor/carpet/black,
/area/ship/science)
"JS" = (
/obj/machinery/power/terminal{
	dir = 8
	},
/obj/structure/cable,
/turf/open/floor/mineral/titanium/yellow,
/area/ship/engineering)
"Ka" = (
/obj/machinery/atmospherics/components/binary/pressure_valve/layer4{
	dir = 1
	},
/turf/open/floor/mineral/titanium/yellow,
/area/ship/engineering)
"MR" = (
/turf/closed/wall/mineral/plastitanium,
/area/ship/bridge)
"Os" = (
/obj/structure/cable{
	icon_state = "2-8"
	},
/obj/structure/cable{
	icon_state = "1-8"
	},
/obj/structure/cable{
	icon_state = "4-8"
	},
/obj/machinery/atmospherics/pipe/manifold4w/supply/hidden/layer4,
/obj/machinery/atmospherics/pipe/manifold4w/scrubbers/hidden,
/turf/open/floor/carpet/black,
/area/ship/hallway/central)
"Ot" = (
/obj/docking_port/mobile{
	port_direction = 8;
	preferred_direction = 4;
	dir = 2
	},
/turf/closed/wall/mineral/plastitanium,
/area/ship/cargo)
"PO" = (
/obj/effect/spawner/structure/window/plasma/reinforced/plastitanium,
/obj/machinery/door/poddoor{
	id = "acron_external"
	},
/obj/machinery/atmospherics/pipe/simple/supply/hidden/layer4{
	dir = 8
	},
/turf/open/floor/carpet/black,
/area/ship/science)
"QU" = (
/turf/open/floor/engine/hull,
/area/ship/external)
"Re" = (
/obj/effect/spawner/structure/window/plasma/reinforced/plastitanium,
/obj/machinery/door/poddoor{
	id = "acron_external";
	dir = 4
	},
/turf/open/floor/carpet/royalblack,
/area/ship/bridge)
"Ru" = (
/obj/structure/cable{
	icon_state = "4-8"
	},
/obj/machinery/light_switch{
	dir = 1;
	pixel_x = 11;
	pixel_y = -16
	},
/obj/machinery/atmospherics/pipe/simple/supply/hidden/layer4{
	dir = 8
	},
/obj/machinery/atmospherics/pipe/simple/scrubbers/hidden{
	dir = 8
	},
/turf/open/floor/carpet/black,
/area/ship/cargo)
"Tg" = (
/turf/closed/wall/mineral/plastitanium,
/area/ship/science)
"TS" = (
/obj/machinery/atmospherics/components/unary/outlet_injector/atmos/atmos_waste,
/turf/open/floor/engine/hull,
/area/ship/external)
"UV" = (
/obj/structure/cable{
	icon_state = "4-8"
	},
/obj/machinery/atmospherics/pipe/simple/supply/hidden/layer4{
	dir = 8
	},
/obj/machinery/atmospherics/pipe/simple/scrubbers/hidden{
	dir = 8
	},
/obj/machinery/atmospherics/pipe/simple/supply/hidden/layer4{
	dir = 8
	},
/obj/machinery/door/airlock/engineering{
	dir = 4;
	name = "Engineering"
	},
/turf/open/floor/carpet/black,
/area/ship/hallway/central)
"Vm" = (
/obj/machinery/button/door{
	dir = 8;
	pixel_x = 22;
	pixel_y = 10;
	name = "blast door control";
	id = "acron_external"
	},
/obj/machinery/atmospherics/pipe/simple/scrubbers/hidden{
	dir = 10
	},
/obj/machinery/turretid{
	pixel_x = 32;
	pixel_y = 8
	},
/turf/open/floor/carpet/royalblack,
/area/ship/bridge)
"Vy" = (
/obj/machinery/power/apc/auto_name/directional/east,
/obj/structure/cable{
	icon_state = "0-8"
	},
/obj/machinery/atmospherics/components/unary/vent_pump/on/layer4{
	dir = 8
	},
/obj/machinery/airalarm/directional/south,
/turf/open/floor/carpet/blue,
/area/ship/medical)
"VA" = (
/obj/machinery/atmospherics/components/unary/tank/air,
/turf/open/floor/mineral/titanium/yellow,
/area/ship/engineering)
"VD" = (
/obj/machinery/atmospherics/pipe/simple/scrubbers/hidden{
	dir = 8
	},
/obj/machinery/atmospherics/pipe/manifold/supply/hidden/layer4{
	dir = 1
	},
/turf/open/floor/mineral/titanium/yellow,
/area/ship/engineering)
"VX" = (
/obj/structure/cable{
	icon_state = "4-8"
	},
/obj/machinery/atmospherics/pipe/simple/supply/hidden/layer4{
	dir = 8
	},
/obj/machinery/atmospherics/pipe/simple/scrubbers/hidden{
	dir = 8
	},
/turf/open/floor/carpet/black,
/area/ship/hallway/central)
"Wy" = (
/obj/machinery/power/smes/shuttle/precharged{
	dir = 4
	},
/obj/structure/cable{
	icon_state = "0-8"
	},
/turf/open/floor/mineral/titanium/yellow,
/area/ship/engineering)
"WH" = (
/obj/machinery/camera/autoname{
	dir = 8
	},
/obj/structure/closet/wall{
	dir = 6;
	pixel_y = -32;
	name = "Mining Closet"
	},
/obj/item/mining_scanner,
/obj/item/mining_scanner,
/obj/item/pickaxe,
/obj/item/pickaxe,
/obj/item/storage/bag/ore,
/turf/open/floor/carpet/black,
/area/ship/cargo)
"WI" = (
/obj/machinery/power/terminal{
	dir = 1
	},
/obj/structure/cable{
	icon_state = "0-2"
	},
/obj/machinery/atmospherics/components/unary/vent_scrubber/on{
	dir = 4
	},
/turf/open/floor/mineral/titanium/yellow,
/area/ship/engineering)
"Xk" = (
/obj/machinery/button/door{
	dir = 8;
	pixel_x = 22;
	pixel_y = 10;
	name = "blast door control";
	id = "acron_eng"
	},
/obj/machinery/light_switch{
	pixel_x = 22;
	pixel_y = null;
	dir = 8
	},
/turf/open/floor/mineral/titanium/yellow,
/area/ship/engineering)
"Xu" = (
/obj/structure/cable{
	icon_state = "1-4"
	},
/obj/machinery/atmospherics/pipe/simple/supply/hidden/layer4{
	dir = 5
	},
/obj/machinery/atmospherics/pipe/simple/scrubbers/hidden{
	dir = 7
	},
/turf/open/floor/carpet/purple,
/area/ship/science)
"Yk" = (
/turf/template_noop,
/area/template_noop)
"ZK" = (
/obj/structure/table,
/obj/item/radio/intercom/wideband/table{
	dir = 6
	},
/obj/machinery/atmospherics/pipe/simple/supply/hidden/layer4{
	dir = 9
	},
/obj/item/areaeditor/shuttle,
/turf/open/floor/carpet/royalblack,
/area/ship/bridge)

(1,1,1) = {"
xz
eb
eb
qv
qv
qv
eb
eb
sB
"}
(2,1,1) = {"
pG
Wy
Wy
Ek
WI
zB
Wy
Wy
pG
"}
(3,1,1) = {"
pG
Aq
hY
fm
rG
Dr
zL
JS
pG
"}
(4,1,1) = {"
pG
Ea
vG
Xk
VD
kV
Ka
VA
pG
"}
(5,1,1) = {"
Gl
Gl
Gl
Gl
UV
Tg
Tg
Tg
Tg
"}
(6,1,1) = {"
Gl
Gl
vC
Gl
VX
Tg
vQ
Tg
Tg
"}
(7,1,1) = {"
na
AQ
mQ
Gl
Fg
Tg
tY
nx
PO
"}
(8,1,1) = {"
na
hx
CA
Bf
Os
JA
Xu
Fa
JR
"}
(9,1,1) = {"
na
IJ
Vy
Gl
eH
Tg
aU
EK
JR
"}
(10,1,1) = {"
na
iv
dK
dK
Ru
dK
dK
hA
JR
"}
(11,1,1) = {"
Gl
Gl
dK
bJ
ig
Hw
dK
Tg
Tg
"}
(12,1,1) = {"
Yk
Yk
Ot
CM
od
vn
dK
Yk
Yk
"}
(13,1,1) = {"
Yk
QU
di
sc
od
tA
dK
Yk
Yk
"}
(14,1,1) = {"
Yk
TS
iQ
xr
Au
yR
Cq
Yk
Yk
"}
(15,1,1) = {"
Yk
QU
zc
vA
od
WH
dK
Yk
Yk
"}
(16,1,1) = {"
Yk
gs
MR
MR
Ht
MR
MR
bj
Yk
"}
(17,1,1) = {"
Yk
kB
tt
hh
gA
ck
JB
kB
Yk
"}
(18,1,1) = {"
Yk
og
zN
Vm
HD
oQ
zN
kB
Yk
"}
(19,1,1) = {"
Yk
Dn
Re
tB
fz
ZK
Re
Dn
Yk
"}
(20,1,1) = {"
Yk
Yk
Re
Re
Re
Re
Re
Yk
Yk
"}
