//MAP CONVERTED BY dmm2tgm.py THIS HEADER COMMENT PREVENTS RECONVERSION, DO NOT REMOVE
"c" = (
/obj/machinery/power/apc/auto_name/directional/south,
/obj/structure/cable,
/turf/open/floor/pod,
/area/ship/bridge)
"f" = (
/obj/machinery/light/directional/south,
/turf/open/floor/pod,
/area/ship/bridge)
"n" = (
/obj/machinery/computer/helm{
	dir = 8
	},
/turf/open/floor/pod,
/area/ship/bridge)
"o" = (
/obj/structure/cable{
	icon_state = "0-8"
	},
/obj/machinery/power/smes/shuttle/micro/precharged{
	dir = 4
	},
/obj/machinery/light/directional/north,
/turf/open/floor/pod,
/area/ship/bridge)
"p" = (
/turf/closed/wall/rust,
/area/ship/bridge)
"A" = (
/turf/open/floor/pod,
/area/ship/bridge)
"B" = (
/obj/machinery/power/terminal{
	dir = 8
	},
/obj/structure/cable{
	icon_state = "0-4"
	},
/obj/machinery/light_switch{
	pixel_y = 24
	},
/turf/open/floor/pod,
/area/ship/bridge)
"E" = (
/obj/machinery/power/shuttle/engine/electric/bad{
	dir = 4
	},
/obj/structure/window/reinforced/spawner/east,
/obj/structure/cable{
	icon_state = "0-4"
	},
/turf/open/floor/engine/hull,
/area/ship/bridge)
"F" = (
/obj/effect/spawner/structure/window/reinforced,
/obj/structure/grille,
/turf/open/floor/pod,
/area/ship/bridge)
"H" = (
/obj/structure/closet,
/obj/item/pickaxe/emergency,
/obj/item/storage/bag/ore,
/obj/item/circuitboard/machine/ore_redemption,
/obj/item/circuitboard/machine/autolathe,
/obj/machinery/light/directional/south,
/obj/item/storage/firstaid/ancient,
/obj/item/shovel,
/obj/item/storage/bag/plants/portaseeder,
/obj/effect/spawner/lootdrop/ration,
/obj/effect/spawner/lootdrop/ration,
/obj/effect/spawner/lootdrop/ration,
/obj/item/storage/toolbox/emergency,
/obj/item/kitchen/knife/shiv,
/turf/open/floor/pod,
/area/ship/bridge)
"K" = (
/obj/structure/chair/comfy/shuttle{
	dir = 4
	},
/obj/structure/cable{
	icon_state = "1-2"
	},
/turf/open/floor/pod,
/area/ship/bridge)
"L" = (
/turf/template_noop,
/area/template_noop)
"M" = (
/obj/structure/cable{
	icon_state = "4-8"
	},
/obj/structure/cable{
	icon_state = "2-4"
	},
/turf/open/floor/pod,
/area/ship/bridge)
"Q" = (
/obj/structure/closet/wall/blue{
	dir = 4;
	name = "Equipment closet";
	pixel_x = -30
	},
/obj/item/clothing/suit/space/fragile,
/obj/item/clothing/head/helmet/space/orange,
/obj/item/radio,
/obj/effect/spawner/lootdrop/ration,
/obj/item/areaeditor/shuttle,
/obj/item/stack/sheet/mineral/plasma/twenty,
/obj/item/tank/internals/emergency_oxygen/double,
/obj/machinery/cryopod/poor{
	dir = 4
	},
/turf/open/floor/pod,
/area/ship/bridge)
"T" = (
/obj/structure/cable{
	icon_state = "0-8"
	},
/obj/machinery/power/port_gen/pacman,
/obj/item/wrench,
/obj/machinery/light/directional/north,
/turf/open/floor/pod,
/area/ship/bridge)
"U" = (
/obj/machinery/door/airlock/hatch{
	dir = 4
	},
/obj/structure/fans/tiny,
/obj/docking_port/mobile{
	dir = 8;
	preferred_direction = 4;
	set_dir_on_move = 4
	},
/turf/open/floor/pod,
/area/ship/bridge)

(1,1,1) = {"
L
L
L
L
L
L
L
"}
(2,1,1) = {"
L
p
E
p
U
p
L
"}
(3,1,1) = {"
L
p
o
Q
f
p
L
"}
(4,1,1) = {"
L
p
B
A
A
p
L
"}
(5,1,1) = {"
L
p
M
K
c
p
L
"}
(6,1,1) = {"
L
p
T
n
H
p
L
"}
(7,1,1) = {"
L
p
p
F
p
p
L
"}
(8,1,1) = {"
L
L
L
L
L
L
L
"}
