//MAP CONVERTED BY dmm2tgm.py THIS HEADER COMMENT PREVENTS RECONVERSION, DO NOT REMOVE
"aU" = (
/obj/machinery/atmospherics/pipe/simple/scrubbers/hidden/layer4{
	dir = 9
	},
/obj/structure/table,
/obj/item/storage/firstaid/regular,
/obj/item/storage/backpack/duffelbag/syndie/spiderclan_surg,
/turf/open/floor/wood/yew,
/area/ship/crew/cryo)
"bj" = (
/obj/machinery/porta_turret/syndicate/energy{
	dir = 6;
	faction = list("Space Ninja")
	},
/turf/closed/wall/mineral/plastitanium/nodiagonal,
/area/ship/bridge)
"bJ" = (
/obj/machinery/atmospherics/pipe/simple/scrubbers/hidden/layer4{
	dir = 10
	},
/obj/structure/chair/comfy/shuttle{
	dir = 4
	},
/turf/open/floor/circuit/green,
/area/ship/bridge)
"ck" = (
/obj/structure/cable{
	icon_state = "2-8"
	},
/obj/structure/closet/crate/freezer,
/obj/item/storage/ration/vegan_chili,
/obj/item/storage/ration/vegan_chili,
/obj/item/storage/ration/vegan_chili,
/obj/item/reagent_containers/food/drinks/waterbottle,
/obj/item/reagent_containers/food/drinks/waterbottle,
/obj/item/reagent_containers/food/drinks/waterbottle,
/obj/item/reagent_containers/spray/cleaner,
/obj/item/soap/homemade,
/turf/open/floor/circuit/green/off,
/area/ship/engineering)
"cR" = (
/obj/machinery/power/shuttle/engine/electric{
	dir = 4
	},
/obj/structure/cable{
	icon_state = "0-4"
	},
/obj/structure/cable{
	icon_state = "0-4"
	},
/obj/structure/window/plasma/reinforced/spawner/east,
/obj/machinery/door/poddoor{
	id = "acron_eng";
	dir = 4
	},
/turf/open/floor/circuit/green/off,
/area/ship/engineering)
"di" = (
/obj/structure/cable{
	icon_state = "1-4"
	},
/obj/structure/closet/emcloset/wall{
	dir = 4;
	pixel_x = -28
	},
/obj/effect/turf_decal/industrial/warning{
	dir = 1
	},
/obj/effect/turf_decal/industrial/stand_clear,
/turf/open/floor/circuit/green/off,
/area/ship/hallway/central)
"dl" = (
/obj/machinery/light/directional/east,
/obj/machinery/computer/operating{
	dir = 1
	},
/turf/open/floor/wood/yew,
/area/ship/crew/cryo)
"dK" = (
/obj/structure/table/optable,
/obj/effect/decal/cleanable/blood,
/turf/open/floor/wood/yew,
/area/ship/crew/cryo)
"eb" = (
/obj/machinery/atmospherics/components/binary/pump/on{
	dir = 1
	},
/obj/machinery/light/directional/east,
/obj/effect/decal/cleanable/oil,
/turf/open/floor/circuit/green/off,
/area/ship/engineering)
"eH" = (
/obj/structure/cable{
	icon_state = "1-2"
	},
/obj/machinery/atmospherics/pipe/simple/scrubbers/hidden/layer4,
/obj/machinery/atmospherics/pipe/simple/supply/hidden,
/obj/machinery/door/airlock/survival_pod,
/obj/machinery/door/firedoor,
/turf/open/floor/wood/yew,
/area/ship/crew/cryo)
"fm" = (
/obj/machinery/power/terminal{
	dir = 1
	},
/obj/machinery/power/port_gen/pacman{
	anchored = 1
	},
/obj/item/stack/sheet/mineral/plasma/twenty,
/obj/machinery/airalarm/directional/west,
/turf/open/floor/circuit/green/off,
/area/ship/engineering)
"fz" = (
/obj/machinery/atmospherics/pipe/simple/supply/hidden{
	dir = 10
	},
/obj/machinery/atmospherics/pipe/simple/scrubbers/hidden/layer4{
	dir = 9
	},
/obj/machinery/button/door{
	dir = 8;
	pixel_x = 32;
	pixel_y = -5;
	name = "blast door control";
	id = "113"
	},
/obj/machinery/turretid{
	pixel_x = 32;
	pixel_y = 12
	},
/obj/machinery/holopad,
/obj/effect/decal/cleanable/dirt/dust,
/turf/open/floor/circuit/green,
/area/ship/bridge)
"gs" = (
/obj/machinery/power/smes/shuttle/precharged{
	dir = 4
	},
/obj/structure/cable{
	icon_state = "0-8"
	},
/obj/structure/cable,
/turf/open/floor/circuit/green/off,
/area/ship/engineering)
"gA" = (
/obj/machinery/porta_turret/syndicate/energy{
	dir = 9;
	faction = list("Space Ninja")
	},
/turf/closed/wall/mineral/plastitanium/nodiagonal,
/area/ship/bridge)
"gY" = (
/obj/effect/decal/cleanable/xenoblood/xgibs/limb,
/obj/effect/decal/cleanable/dirt/dust,
/turf/open/floor/circuit/green/off,
/area/ship/bridge)
"hh" = (
/obj/structure/cable{
	icon_state = "4-8"
	},
/obj/machinery/atmospherics/pipe/simple/scrubbers/hidden/layer4{
	dir = 4
	},
/obj/machinery/atmospherics/pipe/simple/supply/hidden{
	dir = 8
	},
/obj/machinery/door/airlock/survival_pod{
	dir = 4
	},
/obj/machinery/door/firedoor,
/turf/open/floor/circuit/green,
/area/ship/hallway/central)
"hx" = (
/obj/structure/cable{
	icon_state = "4-8"
	},
/obj/machinery/atmospherics/pipe/simple/supply/hidden{
	dir = 8
	},
/obj/machinery/atmospherics/pipe/simple/scrubbers/hidden/layer4{
	dir = 4
	},
/obj/structure/cable{
	icon_state = "1-8"
	},
/turf/open/floor/circuit/green,
/area/ship/hallway/central)
"hA" = (
/obj/effect/spawner/structure/window/plasma/reinforced/plastitanium,
/obj/machinery/door/poddoor/preopen{
	id = 113
	},
/turf/open/floor/carpet/black,
/area/ship/crew/cryo)
"hY" = (
/obj/machinery/power/smes/engineering,
/obj/structure/cable{
	icon_state = "0-4"
	},
/obj/structure/cable{
	icon_state = "1-8"
	},
/turf/open/floor/circuit/green/off,
/area/ship/engineering)
"ig" = (
/obj/structure/cable{
	icon_state = "4-8"
	},
/obj/machinery/atmospherics/pipe/simple/supply/hidden{
	dir = 8
	},
/obj/machinery/atmospherics/pipe/simple/scrubbers/hidden/layer4{
	dir = 4
	},
/obj/effect/decal/cleanable/blood/gibs/limb,
/obj/effect/decal/cleanable/dirt/dust,
/turf/open/floor/circuit/green,
/area/ship/hallway/central)
"iv" = (
/obj/machinery/atmospherics/components/unary/vent_pump/on{
	dir = 8
	},
/obj/structure/cable{
	icon_state = "4-8"
	},
/turf/open/floor/wood/yew,
/area/ship/medical)
"iQ" = (
/obj/machinery/atmospherics/components/unary/vent_scrubber/on/layer4{
	dir = 4
	},
/obj/docking_port/mobile{
	port_direction = 8;
	preferred_direction = 4;
	dir = 2
	},
/obj/structure/cable{
	icon_state = "1-2"
	},
/obj/structure/cable{
	icon_state = "2-8"
	},
/obj/structure/cable{
	icon_state = "2-4"
	},
/obj/effect/turf_decal/industrial/warning{
	dir = 1
	},
/obj/effect/turf_decal/industrial/stand_clear,
/obj/effect/decal/cleanable/blood/footprints,
/turf/open/floor/circuit/green/off,
/area/ship/hallway/central)
"kB" = (
/turf/closed/wall/mineral/plastitanium/interior,
/area/ship/bridge)
"kJ" = (
/obj/structure/closet/wall/blue{
	dir = 4;
	pixel_x = -28
	},
/obj/item/areaeditor/shuttle,
/obj/item/reagent_containers/hypospray/combat/nanites,
/obj/item/reagent_containers/hypospray/medipen/bonefixingjuice,
/turf/open/floor/circuit/green/off,
/area/ship/bridge)
"kV" = (
/obj/machinery/power/terminal{
	dir = 8
	},
/obj/structure/cable,
/obj/effect/decal/cleanable/dirt/dust,
/turf/open/floor/circuit/green/off,
/area/ship/engineering)
"lh" = (
/obj/effect/turf_decal/industrial/warning{
	dir = 8
	},
/turf/open/floor/engine/hull/reinforced,
/area/ship/external)
"me" = (
/obj/effect/spawner/structure/window/plasma/reinforced/plastitanium,
/obj/machinery/door/poddoor/preopen{
	id = 113;
	dir = 1
	},
/turf/open/floor/carpet/royalblack,
/area/ship/bridge)
"mQ" = (
/obj/structure/cable{
	icon_state = "0-8"
	},
/obj/machinery/atmospherics/components/unary/vent_pump/on{
	dir = 8
	},
/obj/machinery/power/apc/auto_name/directional/north,
/turf/open/floor/wood/yew,
/area/ship/crew/cryo)
"na" = (
/obj/machinery/atmospherics/pipe/simple/scrubbers/hidden/layer4{
	dir = 10
	},
/obj/structure/fluff/divine/convertaltar{
	desc = "An altar dedicated to a kami.";
	name = "altar"
	},
/obj/item/toy/katana{
	name = "Хондзё Масамунэ";
	desc = "Великое сокровище , но уже бесполезное в бою."
	},
/turf/open/floor/wood/yew,
/area/ship/medical)
"nx" = (
/turf/closed/wall/mineral/plastitanium/nodiagonal,
/area/ship/crew/cryo)
"od" = (
/obj/machinery/atmospherics/pipe/simple/supply/hidden{
	dir = 9
	},
/obj/machinery/autolathe,
/obj/machinery/airalarm/directional/south,
/turf/open/floor/circuit/green/off,
/area/ship/hallway/central)
"oQ" = (
/obj/machinery/power/apc/auto_name/directional/west,
/obj/structure/cable,
/obj/effect/decal/cleanable/dirt/dust,
/obj/machinery/light_switch{
	dir = 4;
	pixel_x = -19;
	pixel_y = -12
	},
/turf/open/floor/circuit/green/off,
/area/ship/bridge)
"pG" = (
/obj/machinery/light/directional/north,
/obj/structure/table/abductor,
/obj/machinery/cell_charger,
/turf/open/floor/circuit/green/off,
/area/ship/engineering)
"qv" = (
/obj/machinery/door/poddoor{
	id = "acron_cargo"
	},
/obj/machinery/power/shieldwallgen/atmos/roundstart{
	dir = 4;
	id = "acron_holofield"
	},
/obj/structure/cable{
	icon_state = "0-2"
	},
/obj/machinery/door/firedoor,
/obj/effect/turf_decal/industrial/warning{
	dir = 8
	},
/turf/open/floor/circuit/green/off,
/area/ship/hallway/central)
"rG" = (
/obj/structure/table/abductor,
/obj/item/stock_parts/cell/super/empty,
/obj/structure/cable{
	icon_state = "0-2"
	},
/obj/machinery/power/apc/auto_name/directional/north,
/obj/machinery/firealarm/directional/east,
/turf/open/floor/circuit/green/off,
/area/ship/engineering)
"sc" = (
/obj/structure/cable{
	icon_state = "2-8"
	},
/obj/structure/cable{
	icon_state = "1-8"
	},
/obj/structure/cable{
	icon_state = "4-8"
	},
/obj/machinery/atmospherics/pipe/manifold4w/supply/hidden,
/obj/machinery/atmospherics/pipe/manifold4w/scrubbers/hidden/layer4,
/turf/open/floor/circuit/green,
/area/ship/hallway/central)
"sB" = (
/obj/machinery/button/shieldwallgen{
	dir = 2;
	pixel_y = 18;
	id = "acron_holofield";
	pixel_x = -5
	},
/obj/machinery/button/door{
	name = "blast door control";
	id = "acron_cargo";
	dir = 2;
	pixel_y = 20;
	pixel_x = 8
	},
/obj/machinery/power/apc/auto_name/directional/east,
/obj/structure/cable{
	icon_state = "0-2"
	},
/turf/open/floor/circuit/green/off,
/area/ship/hallway/central)
"sW" = (
/turf/closed/wall/mineral/plastitanium/interior,
/area/ship/engineering)
"tt" = (
/obj/machinery/atmospherics/pipe/simple/scrubbers/visible/layer4{
	dir = 8
	},
/obj/machinery/atmospherics/pipe/manifold/supply/visible{
	dir = 1
	},
/obj/structure/cable{
	icon_state = "4-8"
	},
/obj/structure/cable{
	icon_state = "1-4"
	},
/turf/open/floor/circuit/green,
/area/ship/engineering)
"tA" = (
/obj/machinery/light/directional/east,
/obj/structure/cable{
	icon_state = "1-2"
	},
/turf/open/floor/circuit/green/off,
/area/ship/engineering)
"tB" = (
/obj/effect/spawner/structure/window/plasma/reinforced/plastitanium,
/obj/machinery/door/poddoor/preopen{
	id = 113;
	dir = 4
	},
/turf/open/floor/carpet/royalblack,
/area/ship/bridge)
"tY" = (
/obj/machinery/light/directional/west,
/obj/effect/decal/cleanable/ash/large,
/obj/effect/decal/cleanable/dirt/dust,
/turf/open/floor/wood/yew,
/area/ship/crew/cryo)
"vn" = (
/obj/machinery/computer/helm{
	dir = 8
	},
/turf/open/floor/circuit/green/off,
/area/ship/bridge)
"vA" = (
/obj/structure/cable{
	icon_state = "4-8"
	},
/obj/machinery/atmospherics/pipe/manifold/scrubbers/hidden/layer4,
/obj/machinery/atmospherics/pipe/manifold/supply/hidden{
	dir = 1
	},
/obj/effect/decal/cleanable/blood/tracks{
	dir = 10
	},
/obj/effect/decal/cleanable/shreds,
/turf/open/floor/circuit/green,
/area/ship/cargo)
"vC" = (
/turf/open/floor/wood/yew,
/area/ship/medical)
"vG" = (
/obj/structure/cable{
	icon_state = "2-8"
	},
/obj/structure/cable{
	icon_state = "1-2"
	},
/obj/machinery/atmospherics/components/unary/vent_pump/on,
/turf/open/floor/circuit/green/off,
/area/ship/engineering)
"vQ" = (
/turf/closed/wall/mineral/plastitanium/interior,
/area/ship/crew/cryo)
"xr" = (
/obj/structure/cable{
	icon_state = "4-8"
	},
/obj/machinery/atmospherics/pipe/simple/supply/hidden{
	dir = 8
	},
/obj/machinery/atmospherics/pipe/simple/scrubbers/hidden/layer4{
	dir = 4
	},
/obj/structure/cable{
	icon_state = "1-4"
	},
/turf/open/floor/circuit/green,
/area/ship/cargo)
"xz" = (
/obj/structure/table/wood,
/obj/item/reagent_containers/food/drinks/bottle/sake{
	pixel_y = 10;
	pixel_x = 10
	},
/obj/item/reagent_containers/food/drinks/drinkingglass/shotglass,
/obj/item/reagent_containers/food/snacks/vegetariansushiroll{
	pixel_x = -5;
	pixel_y = 7
	},
/obj/structure/cable{
	icon_state = "1-8"
	},
/obj/machinery/firealarm/directional/east,
/turf/open/floor/wood/yew,
/area/ship/medical)
"xA" = (
/obj/machinery/atmospherics/components/unary/tank/air{
	dir = 1
	},
/turf/open/floor/circuit/green/off,
/area/ship/engineering)
"yA" = (
/obj/machinery/porta_turret/syndicate/energy{
	dir = 10;
	faction = list("Space Ninja")
	},
/turf/closed/wall/mineral/plastitanium/nodiagonal,
/area/ship/bridge)
"yR" = (
/turf/closed/wall/mineral/plastitanium/nodiagonal,
/area/ship/hallway/central)
"zc" = (
/obj/machinery/atmospherics/pipe/manifold/scrubbers/hidden/layer4{
	dir = 4
	},
/obj/structure/cable{
	icon_state = "1-8"
	},
/obj/effect/turf_decal/industrial/warning{
	dir = 1
	},
/obj/effect/turf_decal/industrial/stand_clear,
/obj/effect/decal/cleanable/dirt/dust,
/turf/open/floor/circuit/green/off,
/area/ship/hallway/central)
"zn" = (
/obj/machinery/light/directional/west,
/obj/structure/bed,
/obj/item/bedsheet/black,
/obj/machinery/airalarm/directional/north,
/turf/open/floor/wood/yew,
/area/ship/medical)
"zB" = (
/obj/machinery/power/shuttle/engine/electric{
	dir = 4
	},
/obj/structure/cable{
	icon_state = "0-4"
	},
/obj/machinery/door/poddoor{
	id = "acron_eng";
	dir = 4
	},
/obj/structure/cable{
	icon_state = "0-4"
	},
/obj/structure/window/plasma/reinforced/spawner/east,
/turf/open/floor/circuit/green/off,
/area/ship/engineering)
"zL" = (
/obj/machinery/camera/autoname{
	dir = 8
	},
/obj/structure/closet/wall{
	dir = 1;
	pixel_y = -28
	},
/obj/item/pickaxe/drill/jackhammer/old,
/obj/item/card/mining_access_card,
/obj/item/gps/mining,
/obj/machinery/firealarm/directional/east,
/turf/open/floor/circuit/green/off,
/area/ship/hallway/central)
"zN" = (
/obj/machinery/light/directional/west,
/obj/machinery/camera/autoname{
	dir = 4
	},
/obj/machinery/atmospherics/components/unary/vent_scrubber/on/layer4{
	dir = 4
	},
/turf/open/floor/circuit/green/off,
/area/ship/bridge)
"Aq" = (
/obj/machinery/power/smes/shuttle/precharged{
	dir = 4
	},
/obj/structure/cable{
	icon_state = "0-8"
	},
/obj/structure/cable{
	icon_state = "0-2"
	},
/turf/open/floor/circuit/green/off,
/area/ship/engineering)
"Au" = (
/obj/machinery/atmospherics/components/unary/vent_pump/on{
	dir = 4
	},
/obj/structure/closet/wall/orange{
	dir = 1;
	pixel_y = -28
	},
/obj/item/stack/sheet/glass/twenty,
/obj/item/stack/sheet/glass/twenty,
/obj/item/stack/sheet/metal/twenty,
/obj/item/stack/sheet/metal/twenty,
/turf/open/floor/circuit/green/off,
/area/ship/hallway/central)
"AQ" = (
/obj/machinery/camera/autoname{
	dir = 5
	},
/obj/structure/rack,
/obj/item/spear,
/obj/item/katana{
	pixel_x = -3
	},
/obj/item/clothing/suit/chaplainsuit/whiterobe,
/obj/item/clothing/under/pants/white,
/obj/machinery/light_switch{
	dir = 4;
	pixel_x = -23;
	pixel_y = -8
	},
/turf/open/floor/wood/yew,
/area/ship/medical)
"AV" = (
/obj/machinery/atmospherics/pipe/simple/supply/hidden{
	dir = 9
	},
/obj/structure/chair/comfy/shuttle{
	dir = 4
	},
/turf/open/floor/circuit/green,
/area/ship/bridge)
"Bf" = (
/obj/structure/cable{
	icon_state = "4-8"
	},
/obj/machinery/atmospherics/pipe/simple/supply/hidden{
	dir = 8
	},
/obj/machinery/atmospherics/pipe/simple/scrubbers/hidden/layer4{
	dir = 4
	},
/obj/effect/decal/cleanable/glass,
/turf/open/floor/circuit/green,
/area/ship/hallway/central)
"Ce" = (
/obj/effect/turf_decal/siding/wood{
	dir = 1
	},
/obj/effect/turf_decal/siding/wood,
/obj/structure/mineral_door/paperframe,
/turf/open/floor/wood/yew,
/area/ship/medical)
"Cq" = (
/obj/machinery/atmospherics/components/unary/vent_scrubber/on/layer4{
	dir = 4
	},
/turf/open/floor/wood/yew,
/area/ship/medical)
"CA" = (
/obj/effect/turf_decal/siding/wood,
/obj/effect/turf_decal/siding/wood{
	dir = 1
	},
/obj/structure/mineral_door/paperframe,
/turf/open/floor/wood/yew,
/area/ship/medical)
"CM" = (
/obj/structure/cable{
	icon_state = "2-8"
	},
/obj/structure/cable{
	icon_state = "4-8"
	},
/obj/machinery/atmospherics/pipe/simple/supply/hidden{
	dir = 8
	},
/obj/machinery/atmospherics/pipe/simple/scrubbers/hidden/layer4{
	dir = 4
	},
/obj/machinery/door/airlock/survival_pod{
	dir = 4
	},
/obj/machinery/door/firedoor,
/turf/open/floor/circuit/green,
/area/ship/hallway/central)
"Dr" = (
/obj/structure/cable{
	icon_state = "1-4"
	},
/obj/machinery/atmospherics/pipe/simple/supply/hidden{
	dir = 5
	},
/obj/machinery/atmospherics/pipe/simple/scrubbers/hidden/layer4,
/obj/effect/decal/cleanable/blood/splatter,
/turf/open/floor/wood/yew,
/area/ship/crew/cryo)
"DH" = (
/obj/structure/cable{
	icon_state = "4-8"
	},
/obj/machinery/atmospherics/pipe/simple/supply/hidden{
	dir = 8
	},
/obj/machinery/atmospherics/pipe/simple/scrubbers/hidden/layer4{
	dir = 4
	},
/turf/open/floor/circuit/green,
/area/ship/hallway/central)
"Ea" = (
/obj/machinery/power/terminal{
	dir = 8
	},
/obj/structure/cable{
	icon_state = "0-2"
	},
/obj/effect/decal/cleanable/dirt/dust,
/turf/open/floor/circuit/green/off,
/area/ship/engineering)
"Ek" = (
/obj/machinery/light/directional/south,
/obj/machinery/mineral/ore_redemption{
	dir = 1;
	output_dir = 1
	},
/turf/open/floor/circuit/green/off,
/area/ship/hallway/central)
"EK" = (
/obj/machinery/button/door{
	dir = 8;
	pixel_x = 22;
	pixel_y = 10;
	name = "blast door control";
	id = "acron_eng"
	},
/obj/machinery/light_switch{
	pixel_x = 21;
	pixel_y = null;
	dir = 8
	},
/obj/structure/cable{
	icon_state = "1-2"
	},
/obj/effect/decal/cleanable/dirt/dust,
/turf/open/floor/circuit/green,
/area/ship/engineering)
"Fa" = (
/obj/effect/spawner/structure/window/plasma/reinforced/plastitanium,
/obj/machinery/atmospherics/pipe/simple/supply/hidden/layer4{
	dir = 8
	},
/obj/machinery/door/poddoor/preopen{
	id = 113
	},
/turf/open/floor/carpet/black,
/area/ship/crew/cryo)
"Fg" = (
/obj/effect/spawner/structure/window/plasma/reinforced/plastitanium,
/obj/machinery/door/poddoor/preopen{
	id = 113
	},
/obj/structure/curtain/bounty,
/turf/open/floor/carpet/black,
/area/ship/medical)
"Gl" = (
/turf/closed/wall/mineral/plastitanium/interior,
/area/ship/medical)
"Ht" = (
/obj/structure/cable{
	icon_state = "4-8"
	},
/obj/machinery/atmospherics/pipe/simple/scrubbers/hidden/layer4{
	dir = 4
	},
/obj/machinery/atmospherics/pipe/simple/supply/hidden{
	dir = 8
	},
/obj/machinery/door/airlock/survival_pod{
	dir = 4
	},
/obj/machinery/door/firedoor,
/turf/open/floor/circuit/green,
/area/ship/bridge)
"Hw" = (
/obj/machinery/airalarm/directional/north,
/obj/machinery/firealarm/directional/east,
/obj/effect/decal/cleanable/dirt/dust,
/turf/open/floor/wood/yew,
/area/ship/crew/cryo)
"HD" = (
/obj/machinery/light/directional/west,
/obj/machinery/camera/autoname{
	dir = 5
	},
/obj/structure/cable{
	icon_state = "1-2"
	},
/obj/machinery/atmospherics/components/unary/vent_pump/on{
	dir = 4
	},
/obj/effect/decal/cleanable/dirt/dust,
/turf/open/floor/circuit/green/off,
/area/ship/bridge)
"IJ" = (
/obj/machinery/atmospherics/pipe/simple/supply/hidden{
	dir = 6
	},
/obj/machinery/atmospherics/pipe/simple/scrubbers/hidden/layer4,
/obj/structure/cable{
	icon_state = "2-4"
	},
/turf/open/floor/wood/yew,
/area/ship/medical)
"JA" = (
/obj/machinery/light_switch{
	pixel_y = 18
	},
/obj/effect/decal/cleanable/dirt/dust,
/turf/open/floor/wood/yew,
/area/ship/crew/cryo)
"JB" = (
/turf/closed/wall/mineral/plastitanium/nodiagonal,
/area/ship/bridge)
"JR" = (
/obj/machinery/computer/cargo/express{
	dir = 8
	},
/obj/effect/decal/cleanable/dirt/dust,
/turf/open/floor/circuit/green/off,
/area/ship/bridge)
"JS" = (
/obj/machinery/atmospherics/components/unary/outlet_injector/atmos/atmos_waste,
/obj/effect/turf_decal/industrial/warning{
	dir = 4
	},
/obj/effect/decal/cleanable/wrapping,
/turf/open/floor/engine/hull/reinforced,
/area/ship/external)
"Ka" = (
/obj/machinery/light/directional/south,
/obj/structure/table/abductor,
/obj/item/clothing/glasses/meson,
/obj/item/wrench/combat,
/turf/open/floor/circuit/green/off,
/area/ship/engineering)
"Ll" = (
/obj/structure/cable{
	icon_state = "4-8"
	},
/obj/machinery/atmospherics/pipe/simple/supply/hidden{
	dir = 8
	},
/obj/machinery/atmospherics/pipe/simple/scrubbers/hidden/layer4{
	dir = 4
	},
/obj/machinery/light_switch{
	dir = 1;
	pixel_y = -18
	},
/turf/open/floor/circuit/green,
/area/ship/hallway/central)
"MR" = (
/obj/structure/cable{
	icon_state = "4-8"
	},
/obj/machinery/atmospherics/pipe/simple/supply/hidden{
	dir = 8
	},
/obj/machinery/atmospherics/pipe/simple/scrubbers/hidden/layer4{
	dir = 4
	},
/obj/effect/decal/cleanable/dirt/dust,
/turf/open/floor/circuit/green,
/area/ship/hallway/central)
"Nn" = (
/obj/effect/spawner/structure/window/plasma/reinforced/plastitanium,
/obj/machinery/door/poddoor/preopen{
	id = 113
	},
/turf/open/floor/carpet/royalblack,
/area/ship/bridge)
"Os" = (
/obj/machinery/light/directional/east,
/obj/structure/chair/stool,
/obj/structure/cable{
	icon_state = "0-2"
	},
/obj/machinery/power/apc/auto_name/directional/north,
/obj/machinery/light_switch{
	pixel_x = 12;
	pixel_y = 23
	},
/turf/open/floor/wood/yew,
/area/ship/medical)
"Ot" = (
/turf/closed/wall/mineral/wood,
/area/ship/medical)
"PO" = (
/obj/structure/table/abductor,
/obj/item/card/emag/limited,
/turf/open/floor/circuit/green/off,
/area/ship/bridge)
"QU" = (
/obj/machinery/atmospherics/pipe/layer_manifold,
/obj/machinery/power/shieldwallgen/atmos/roundstart{
	id = "acron_holofield";
	dir = 8
	},
/obj/structure/cable{
	icon_state = "0-2"
	},
/obj/machinery/door/poddoor{
	id = "acron_cargo"
	},
/obj/machinery/door/firedoor,
/obj/effect/turf_decal/industrial/warning{
	dir = 4
	},
/turf/open/floor/circuit/green/off,
/area/ship/hallway/central)
"Re" = (
/obj/item/radio/intercom/wideband/directional/south,
/obj/structure/table/abductor,
/obj/item/book/granter/spell/smoke/lesser{
	desc = "This book is overflowing with the mystical arts of the ninja.";
	name = "Ninja Vanish"
	},
/obj/machinery/firealarm/directional/east,
/turf/open/floor/circuit/green/off,
/area/ship/bridge)
"Ru" = (
/turf/open/floor/engine/hull/reinforced,
/area/ship/external)
"Tg" = (
/obj/machinery/camera/autoname{
	dir = 4
	},
/obj/machinery/cryopod,
/obj/machinery/computer/cryopod/directional/north,
/turf/open/floor/wood/yew,
/area/ship/crew/cryo)
"TS" = (
/obj/machinery/door/poddoor{
	id = "acron_cargo"
	},
/obj/machinery/door/firedoor,
/turf/open/floor/circuit/green/off,
/area/ship/hallway/central)
"UV" = (
/obj/machinery/atmospherics/pipe/simple/supply/visible,
/obj/structure/closet/wall/orange{
	dir = 8;
	pixel_x = 28
	},
/obj/item/storage/toolbox/mechanical,
/obj/item/storage/toolbox/mechanical,
/obj/item/storage/toolbox/electrical,
/obj/item/storage/toolbox/electrical,
/obj/item/multitool,
/turf/open/floor/circuit/green,
/area/ship/engineering)
"Vm" = (
/obj/structure/cable{
	icon_state = "2-8"
	},
/obj/machinery/atmospherics/pipe/simple/supply/hidden{
	dir = 8
	},
/obj/machinery/atmospherics/pipe/simple/scrubbers/hidden/layer4{
	dir = 4
	},
/turf/open/floor/circuit/green,
/area/ship/bridge)
"Vy" = (
/obj/effect/turf_decal/siding/wood,
/obj/effect/turf_decal/siding/wood{
	dir = 1
	},
/obj/structure/mineral_door/paperframe,
/obj/structure/cable{
	icon_state = "1-2"
	},
/turf/open/floor/wood/yew,
/area/ship/medical)
"VA" = (
/obj/structure/table/abductor,
/obj/item/spacecash/bundle/c1000,
/obj/item/spacecash/bundle/c1000,
/obj/item/flashlight/seclite,
/obj/item/radio,
/obj/machinery/airalarm/directional/north,
/turf/open/floor/circuit/green/off,
/area/ship/bridge)
"VD" = (
/obj/structure/cable{
	icon_state = "1-2"
	},
/obj/machinery/atmospherics/components/unary/vent_scrubber/on/layer4{
	dir = 1
	},
/turf/open/floor/circuit/green/off,
/area/ship/engineering)
"VP" = (
/obj/machinery/porta_turret/syndicate/energy{
	dir = 5;
	faction = list("Space Ninja")
	},
/turf/closed/wall/mineral/plastitanium/nodiagonal,
/area/ship/bridge)
"VX" = (
/turf/closed/wall/mineral/plastitanium/nodiagonal,
/area/ship/medical)
"Wy" = (
/turf/closed/wall/mineral/plastitanium/nodiagonal,
/area/ship/engineering)
"WH" = (
/obj/machinery/atmospherics/pipe/manifold/supply/hidden/layer4{
	dir = 1
	},
/turf/closed/wall/mineral/plastitanium/nodiagonal,
/area/ship/hallway/central)
"WI" = (
/obj/machinery/power/shuttle/engine/electric{
	dir = 4
	},
/obj/structure/cable{
	icon_state = "0-4"
	},
/obj/structure/window/plasma/reinforced/spawner/east,
/obj/machinery/door/poddoor{
	id = "acron_eng";
	dir = 4
	},
/turf/open/floor/circuit/green/off,
/area/ship/engineering)
"Xk" = (
/obj/structure/cable{
	icon_state = "1-4"
	},
/obj/structure/cable{
	icon_state = "1-2"
	},
/obj/machinery/atmospherics/pipe/simple/supply/visible{
	dir = 5
	},
/obj/machinery/atmospherics/pipe/simple/scrubbers/visible/layer4{
	dir = 6
	},
/obj/effect/decal/cleanable/insectguts,
/turf/open/floor/circuit/green/off,
/area/ship/engineering)
"Xu" = (
/obj/machinery/atmospherics/components/unary/vent_scrubber/on/layer4{
	dir = 4
	},
/turf/open/floor/wood/yew,
/area/ship/crew/cryo)
"Yk" = (
/turf/template_noop,
/area/template_noop)
"ZK" = (
/turf/open/floor/circuit/green/off,
/area/ship/bridge)

(1,1,1) = {"
Yk
Yk
Yk
Yk
Yk
Yk
Yk
Yk
Yk
Yk
Yk
"}
(2,1,1) = {"
Yk
gA
Wy
zB
WI
Wy
WI
cR
Wy
yA
Yk
"}
(3,1,1) = {"
Yk
Wy
sW
Aq
hY
fm
ck
gs
sW
Wy
Yk
"}
(4,1,1) = {"
Yk
Wy
pG
Ea
vG
Xk
VD
kV
Ka
Wy
Yk
"}
(5,1,1) = {"
Yk
Wy
rG
tA
EK
tt
UV
eb
xA
Wy
Yk
"}
(6,1,1) = {"
Yk
VX
Ot
Ot
Ot
hh
vQ
vQ
vQ
nx
Yk
"}
(7,1,1) = {"
Yk
VX
zn
AQ
CA
MR
vQ
Tg
tY
nx
Yk
"}
(8,1,1) = {"
Yk
Fg
Cq
vC
CA
Bf
vQ
JA
Xu
Fa
Yk
"}
(9,1,1) = {"
Yk
Fg
na
IJ
Vy
sc
eH
Dr
aU
hA
Yk
"}
(10,1,1) = {"
Yk
Fg
vC
iv
CA
DH
vQ
mQ
dK
hA
Yk
"}
(11,1,1) = {"
Yk
VX
Os
xz
Ce
Ll
vQ
Hw
dl
nx
Yk
"}
(12,1,1) = {"
Yk
VX
VX
VX
Gl
CM
vQ
nx
nx
nx
Yk
"}
(13,1,1) = {"
Yk
Yk
lh
qv
di
ig
Ek
yR
Yk
Yk
Yk
"}
(14,1,1) = {"
Yk
Yk
Ru
TS
iQ
xr
Au
yR
Yk
Yk
Yk
"}
(15,1,1) = {"
Yk
Yk
JS
QU
zc
vA
od
WH
Yk
Yk
Yk
"}
(16,1,1) = {"
Yk
Yk
VP
yR
sB
hx
zL
yR
bj
Yk
Yk
"}
(17,1,1) = {"
Yk
Yk
JB
kB
kB
Ht
kB
kB
JB
Yk
Yk
"}
(18,1,1) = {"
Yk
Yk
Nn
kJ
zN
Vm
HD
oQ
me
Yk
Yk
"}
(19,1,1) = {"
Yk
Yk
Nn
gY
bJ
fz
AV
ZK
me
Yk
Yk
"}
(20,1,1) = {"
Yk
Yk
JB
VA
vn
PO
JR
Re
JB
Yk
Yk
"}
(21,1,1) = {"
Yk
Yk
VP
JB
tB
tB
tB
JB
VP
Yk
Yk
"}
(22,1,1) = {"
Yk
Yk
Yk
Yk
Yk
Yk
Yk
Yk
Yk
Yk
Yk
"}
