//MAP CONVERTED BY dmm2tgm.py THIS HEADER COMMENT PREVENTS RECONVERSION, DO NOT REMOVE
"b" = (
/turf/closed/wall/r_wall,
/area/ship/engineering)
"c" = (
/obj/machinery/power/terminal{
	dir = 8
	},
/obj/structure/cable{
	icon_state = "0-2"
	},
/obj/machinery/light_switch{
	pixel_y = 23
	},
/obj/structure/rack,
/obj/item/extinguisher,
/obj/item/flashlight,
/obj/item/pickaxe/drill,
/obj/item/shovel,
/obj/item/soap,
/obj/effect/decal/cleanable/cobweb/cobweb2,
/obj/item/storage/bag/ore,
/turf/open/floor/plasteel,
/area/ship/engineering)
"d" = (
/obj/machinery/button/door{
	dir = 8;
	id = 1;
	name = "Blast Door Control";
	pixel_x = 25;
	pixel_y = 5
	},
/obj/item/kirbyplants/random,
/obj/effect/decal/cleanable/chem_pile,
/turf/open/floor/plasteel/dark,
/area/ship/bridge)
"e" = (
/obj/structure/grille,
/obj/effect/spawner/structure/window/reinforced,
/obj/machinery/door/poddoor{
	name = "Blast Door";
	dir = 4
	},
/turf/open/floor/plasteel/dark,
/area/ship/bridge)
"f" = (
/obj/structure/grille,
/obj/effect/spawner/structure/window/reinforced,
/obj/machinery/door/poddoor{
	name = "Blast Door";
	dir = 4
	},
/obj/docking_port/mobile{
	dir = 4;
	launch_status = 0;
	preferred_direction = 4;
	port_direction = 2
	},
/turf/open/floor/plasteel/dark,
/area/ship/bridge)
"g" = (
/obj/machinery/computer/helm{
	dir = 8
	},
/turf/open/floor/plasteel/dark,
/area/ship/bridge)
"h" = (
/obj/machinery/power/shuttle/engine/electric{
	dir = 4
	},
/obj/structure/cable{
	icon_state = "0-4"
	},
/turf/open/floor/plating,
/area/ship/engineering)
"i" = (
/obj/machinery/door/firedoor,
/obj/machinery/door/airlock/external{
	dir = 4
	},
/turf/open/floor/plasteel,
/area/ship/engineering)
"j" = (
/obj/structure/cable/yellow{
	icon_state = "1-2"
	},
/obj/effect/decal/cleanable/blood/drip,
/obj/effect/decal/cleanable/garbage,
/obj/effect/decal/cleanable/wrapping,
/turf/open/floor/plating,
/area/ship/bridge)
"k" = (
/turf/open/floor/plasteel/dark,
/area/ship/bridge)
"l" = (
/turf/template_noop,
/area/template_noop)
"m" = (
/obj/machinery/holopad/emergency,
/turf/open/floor/plasteel/dark,
/area/ship/bridge)
"n" = (
/obj/machinery/door/firedoor/border_only{
	dir = 4
	},
/obj/machinery/light/small/directional/north,
/turf/open/floor/plasteel,
/area/ship/engineering)
"o" = (
/obj/structure/cable{
	icon_state = "1-2"
	},
/obj/machinery/firealarm/directional/east,
/obj/machinery/light/directional/east,
/obj/effect/decal/cleanable/generic,
/turf/open/floor/plasteel,
/area/ship/engineering)
"p" = (
/obj/structure/cable{
	icon_state = "4-8"
	},
/obj/machinery/door/firedoor,
/obj/machinery/door/airlock/external{
	dir = 4
	},
/turf/open/floor/plasteel,
/area/ship/engineering)
"q" = (
/turf/closed/wall/r_wall,
/area/ship/bridge)
"s" = (
/obj/structure/fans/tiny,
/obj/effect/decal/cleanable/dirt,
/obj/machinery/door/airlock/maintenance_hatch{
	dir = 4
	},
/obj/machinery/door/firedoor,
/turf/open/floor/plating,
/area/ship/engineering)
"u" = (
/obj/machinery/power/smes/shuttle/precharged{
	dir = 4
	},
/obj/structure/window/reinforced/spawner{
	dir = 8
	},
/obj/machinery/door/window/eastleft,
/obj/machinery/door/firedoor,
/obj/structure/cable{
	icon_state = "0-8"
	},
/turf/open/floor/plating,
/area/ship/engineering)
"v" = (
/obj/machinery/autolathe,
/obj/machinery/light/directional/east,
/turf/open/floor/plasteel/dark,
/area/ship/bridge)
"w" = (
/obj/structure/cable{
	icon_state = "1-2"
	},
/obj/effect/decal/cleanable/ash,
/turf/open/floor/plasteel/dark,
/area/ship/bridge)
"x" = (
/obj/machinery/light_switch{
	pixel_y = 23
	},
/obj/machinery/vending/snack/random,
/obj/effect/decal/cleanable/dirt,
/turf/open/floor/plasteel/dark,
/area/ship/bridge)
"y" = (
/obj/structure/cable{
	icon_state = "1-2"
	},
/turf/open/floor/plasteel/dark,
/area/ship/bridge)
"z" = (
/obj/item/kirbyplants/random,
/obj/effect/decal/cleanable/blood/old{
	color = "#808080"
	},
/turf/open/floor/plasteel/dark,
/area/ship/bridge)
"A" = (
/obj/structure/chair/comfy/shuttle{
	dir = 4;
	name = "Helm"
	},
/obj/effect/decal/cleanable/dirt,
/obj/effect/decal/cleanable/blood/old{
	color = "#808080"
	},
/turf/open/floor/plasteel/dark,
/area/ship/bridge)
"B" = (
/obj/machinery/power/apc/auto_name/directional/north,
/obj/machinery/power/apc/auto_name/directional/north,
/obj/structure/cable{
	icon_state = "0-2"
	},
/obj/machinery/light/directional/west,
/obj/structure/table,
/obj/machinery/fax,
/obj/effect/decal/cleanable/cobweb,
/turf/open/floor/plasteel/dark,
/area/ship/bridge)
"C" = (
/obj/structure/cable/yellow,
/obj/machinery/power/port_gen/pacman,
/obj/machinery/light/directional/east,
/obj/effect/turf_decal/box/white,
/obj/item/stack/sheet/mineral/plasma/fifty,
/turf/open/floor/plating,
/area/ship/bridge)
"D" = (
/obj/machinery/power/terminal{
	dir = 8
	},
/obj/structure/cable,
/obj/structure/closet/wall{
	dir = 1;
	name = "Radio Closet";
	pixel_y = -30
	},
/obj/item/gps,
/obj/item/storage/toolbox/mechanical,
/obj/item/storage/toolbox/electrical,
/obj/item/storage/firstaid/advanced,
/obj/item/storage/firstaid/medical,
/obj/item/storage/belt/utility/full,
/obj/item/weaponcrafting/receiver,
/obj/effect/decal/cleanable/greenglow,
/turf/open/floor/plasteel,
/area/ship/engineering)
"E" = (
/obj/machinery/computer/cryopod/directional/south,
/obj/machinery/cryopod{
	dir = 1
	},
/obj/machinery/light/directional/west,
/obj/effect/decal/cleanable/greenglow{
	color = "#808080"
	},
/turf/open/floor/plasteel/dark,
/area/ship/bridge)
"F" = (
/obj/structure/closet,
/obj/item/areaeditor/shuttle,
/obj/item/clothing/head/welding,
/obj/item/clothing/gloves/color/yellow,
/obj/item/extinguisher,
/obj/item/flashlight,
/obj/item/paper_bin/bundlenatural,
/obj/item/pen/survival,
/obj/item/spacecash/bundle/c10000,
/obj/item/spacecash/bundle/c10000,
/obj/item/storage/cans/sixbeer,
/obj/effect/decal/cleanable/plastic,
/obj/item/storage/box/donkpockets,
/obj/item/storage/box/donkpockets/donkpocketpizza,
/obj/item/reagent_containers/food/drinks/drinkingglass,
/obj/item/reagent_containers/spray/cleaner,
/turf/open/floor/plasteel/dark,
/area/ship/bridge)
"G" = (
/obj/machinery/computer/cargo/express{
	dir = 8
	},
/turf/open/floor/plasteel/dark,
/area/ship/bridge)
"H" = (
/obj/structure/cable{
	icon_state = "1-2"
	},
/obj/machinery/light/directional/east,
/obj/effect/decal/cleanable/dirt,
/obj/effect/decal/cleanable/ash,
/turf/open/floor/plasteel,
/area/ship/engineering)
"I" = (
/obj/docking_port{
	dwidth = 15;
	dir = 8;
	width = 30;
	height = 15
	},
/turf/template_noop,
/area/template_noop)
"J" = (
/obj/structure/cable{
	icon_state = "1-2"
	},
/obj/structure/cable{
	icon_state = "1-4"
	},
/obj/item/trash/semki,
/obj/effect/decal/cleanable/blood/drip,
/obj/effect/decal/cleanable/confetti,
/turf/open/floor/plating,
/area/ship/engineering)
"K" = (
/obj/structure/cable{
	icon_state = "0-2"
	},
/obj/machinery/power/smes/engineering,
/obj/machinery/light/directional/west,
/obj/effect/decal/cleanable/cobweb,
/turf/open/floor/plating,
/area/ship/engineering)
"L" = (
/obj/structure/cable{
	icon_state = "4-8"
	},
/obj/machinery/door/firedoor,
/obj/machinery/door/airlock/external{
	dir = 4
	},
/turf/open/floor/plasteel/dark,
/area/ship/bridge)
"M" = (
/obj/structure/cable,
/obj/machinery/power/apc/auto_name/directional/south,
/obj/machinery/light/directional/west,
/obj/structure/tank_dispenser/oxygen,
/turf/open/floor/plating,
/area/ship/engineering)
"N" = (
/obj/structure/cable/yellow{
	icon_state = "1-2"
	},
/obj/structure/cable{
	icon_state = "4-8"
	},
/obj/item/trash/can,
/obj/effect/decal/cleanable/blood/old,
/turf/open/floor/plating,
/area/ship/bridge)
"O" = (
/obj/machinery/firealarm/directional/west,
/turf/open/floor/plasteel/dark,
/area/ship/bridge)
"Q" = (
/obj/structure/cable{
	icon_state = "1-2"
	},
/turf/open/floor/plasteel,
/area/ship/engineering)
"R" = (
/obj/machinery/light/directional/east,
/obj/machinery/microwave,
/obj/structure/table,
/obj/machinery/newscaster/directional/north,
/obj/effect/decal/cleanable/cobweb/cobweb2,
/turf/open/floor/plasteel/dark,
/area/ship/bridge)
"S" = (
/obj/machinery/door/firedoor,
/obj/machinery/door/airlock/external{
	dir = 4
	},
/turf/open/floor/plasteel/dark,
/area/ship/bridge)
"T" = (
/obj/structure/fans/tiny,
/obj/machinery/door/airlock/maintenance_hatch{
	dir = 4
	},
/obj/machinery/door/firedoor,
/turf/open/floor/plating,
/area/ship/engineering)
"U" = (
/obj/structure/cable{
	icon_state = "1-8"
	},
/turf/open/floor/plasteel/dark,
/area/ship/bridge)
"V" = (
/obj/machinery/power/terminal{
	dir = 8
	},
/obj/structure/cable/yellow{
	icon_state = "0-2"
	},
/obj/machinery/light/directional/east,
/obj/machinery/suit_storage_unit/standard_unit,
/obj/effect/decal/cleanable/sprayweb,
/turf/open/floor/plating,
/area/ship/bridge)
"W" = (
/obj/structure/cable{
	icon_state = "1-4"
	},
/obj/structure/cable{
	icon_state = "2-4"
	},
/obj/effect/decal/cleanable/dirt,
/turf/open/floor/plasteel,
/area/ship/engineering)
"X" = (
/obj/machinery/power/smes/shuttle/precharged{
	dir = 4
	},
/obj/structure/window/reinforced/spawner{
	dir = 8
	},
/obj/machinery/door/window/eastright,
/obj/machinery/door/firedoor,
/obj/structure/cable{
	icon_state = "0-8"
	},
/turf/open/floor/plating,
/area/ship/engineering)
"Y" = (
/obj/structure/cable{
	icon_state = "1-8"
	},
/obj/structure/cable{
	icon_state = "2-8"
	},
/obj/item/trash/boritos,
/obj/effect/decal/cleanable/dirt,
/obj/effect/decal/cleanable/glass,
/turf/open/floor/plating,
/area/ship/engineering)
"Z" = (
/obj/effect/decal/cleanable/dirt,
/obj/machinery/door/firedoor/border_only{
	dir = 4
	},
/obj/machinery/light/small/directional/south,
/turf/open/floor/plasteel,
/area/ship/engineering)

(1,1,1) = {"
l
l
l
l
l
l
l
l
l
l
"}
(2,1,1) = {"
l
b
l
l
I
l
l
l
b
l
"}
(3,1,1) = {"
l
b
h
b
T
s
b
h
b
l
"}
(4,1,1) = {"
l
b
u
b
n
Z
b
X
b
l
"}
(5,1,1) = {"
l
b
c
H
W
Q
o
D
b
l
"}
(6,1,1) = {"
l
b
b
b
p
i
b
b
b
l
"}
(7,1,1) = {"
l
l
b
K
Y
J
M
b
l
l
"}
(8,1,1) = {"
l
l
q
V
j
N
C
q
l
l
"}
(9,1,1) = {"
l
q
q
q
S
L
q
q
q
l
"}
(10,1,1) = {"
l
q
B
w
y
U
O
E
q
l
"}
(11,1,1) = {"
l
q
x
k
A
m
k
F
q
l
"}
(12,1,1) = {"
l
q
R
d
g
G
z
v
q
l
"}
(13,1,1) = {"
l
q
q
q
f
e
q
q
q
l
"}
(14,1,1) = {"
l
q
l
l
l
l
l
l
q
l
"}
(15,1,1) = {"
l
l
l
l
l
l
l
l
l
l
"}
