//MAP CONVERTED BY dmm2tgm.py THIS HEADER COMMENT PREVENTS RECONVERSION, DO NOT REMOVE
"bd" = (
/obj/item/stack/sheet/mineral/plasma/fifty,
/obj/machinery/power/port_gen/pacman,
/obj/effect/turf_decal/box/white,
/obj/structure/cable/yellow,
/turf/open/floor/plating,
/area/ship/bridge)
"cl" = (
/obj/structure/grille,
/obj/effect/spawner/structure/window/reinforced,
/obj/machinery/door/poddoor{
	name = "Blast Door";
	dir = 4
	},
/turf/open/floor/plasteel/dark,
/area/ship/bridge)
"dB" = (
/obj/machinery/computer/helm{
	dir = 8
	},
/turf/open/floor/plasteel/dark,
/area/ship/bridge)
"dJ" = (
/obj/machinery/firealarm/directional/west,
/turf/open/floor/plasteel/dark,
/area/ship/bridge)
"eE" = (
/obj/effect/decal/cleanable/dirt,
/turf/open/floor/plasteel/dark,
/area/ship/bridge)
"fg" = (
/obj/structure/cable{
	icon_state = "1-2"
	},
/turf/open/floor/plasteel/dark,
/area/ship/bridge)
"fC" = (
/obj/structure/cable{
	icon_state = "1-4"
	},
/obj/structure/cable{
	icon_state = "2-4"
	},
/obj/effect/decal/cleanable/dirt,
/turf/open/floor/plasteel,
/area/ship/engineering)
"fY" = (
/obj/machinery/door/firedoor,
/obj/machinery/door/airlock/external{
	dir = 4
	},
/turf/open/floor/plasteel,
/area/ship/engineering)
"hw" = (
/turf/template_noop,
/area/template_noop)
"hO" = (
/obj/machinery/power/terminal{
	dir = 8
	},
/obj/structure/cable,
/obj/structure/closet/wall{
	dir = 1;
	name = "Radio Closet";
	pixel_y = -30
	},
/obj/item/gps,
/obj/item/storage/toolbox/mechanical,
/obj/item/storage/toolbox/electrical,
/obj/item/storage/firstaid/advanced,
/obj/item/storage/firstaid/medical,
/obj/item/storage/belt/utility/full,
/obj/effect/decal/cleanable/greenglow,
/turf/open/floor/plasteel,
/area/ship/engineering)
"jd" = (
/obj/structure/cable{
	icon_state = "1-8"
	},
/obj/effect/decal/cleanable/dirt,
/turf/open/floor/plasteel/dark,
/area/ship/bridge)
"je" = (
/obj/machinery/light/directional/east,
/obj/machinery/microwave,
/obj/structure/table,
/obj/machinery/newscaster/directional/north,
/obj/effect/decal/cleanable/cobweb/cobweb2,
/turf/open/floor/plasteel/dark,
/area/ship/bridge)
"kC" = (
/obj/effect/decal/cleanable/ash,
/turf/open/floor/plasteel,
/area/ship/engineering)
"lk" = (
/obj/machinery/power/smes/shuttle/precharged{
	dir = 4
	},
/obj/structure/window/reinforced/spawner{
	dir = 8
	},
/obj/structure/cable{
	icon_state = "0-8"
	},
/turf/open/floor/plating,
/area/ship/engineering)
"ll" = (
/turf/open/floor/plasteel,
/area/ship/engineering)
"oR" = (
/obj/machinery/power/apc/auto_name/directional/north,
/obj/structure/cable{
	icon_state = "0-2"
	},
/obj/machinery/light/directional/west,
/obj/structure/table,
/obj/effect/decal/cleanable/cobweb,
/turf/open/floor/plasteel/dark,
/area/ship/bridge)
"pn" = (
/obj/machinery/power/smes/engineering,
/obj/structure/cable{
	icon_state = "0-2"
	},
/obj/effect/decal/cleanable/sprayweb,
/turf/open/floor/plating,
/area/ship/engineering)
"pz" = (
/turf/closed/wall/r_wall,
/area/ship/bridge)
"qt" = (
/obj/machinery/power/apc/auto_name/directional/south,
/obj/structure/tank_dispenser/oxygen,
/obj/structure/cable,
/turf/open/floor/plating,
/area/ship/engineering)
"qR" = (
/obj/machinery/computer/cryopod/directional/south,
/obj/machinery/cryopod{
	dir = 1
	},
/obj/machinery/light/directional/west,
/obj/effect/decal/cleanable/greenglow{
	color = "#808080"
	},
/turf/open/floor/plasteel/dark,
/area/ship/bridge)
"tK" = (
/obj/machinery/autolathe,
/obj/machinery/light/directional/east,
/turf/open/floor/plasteel/dark,
/area/ship/bridge)
"uk" = (
/obj/structure/cable/yellow{
	icon_state = "1-2"
	},
/obj/structure/cable{
	icon_state = "4-8"
	},
/obj/effect/decal/cleanable/blood/old,
/turf/open/floor/plating,
/area/ship/bridge)
"ut" = (
/obj/machinery/computer/cargo/express{
	dir = 8
	},
/turf/open/floor/plasteel/dark,
/area/ship/bridge)
"vw" = (
/obj/machinery/light/directional/east,
/obj/structure/cable/yellow{
	icon_state = "1-2"
	},
/obj/effect/decal/cleanable/dirt,
/obj/effect/decal/cleanable/wrapping,
/turf/open/floor/plating,
/area/ship/bridge)
"wd" = (
/obj/structure/cable{
	icon_state = "4-8"
	},
/obj/machinery/door/firedoor,
/obj/machinery/door/airlock/external{
	dir = 4
	},
/turf/open/floor/plasteel/dark,
/area/ship/bridge)
"xO" = (
/obj/machinery/power/terminal{
	dir = 8
	},
/obj/structure/cable/yellow{
	icon_state = "0-2"
	},
/obj/effect/decal/cleanable/garbage,
/turf/open/floor/plating,
/area/ship/bridge)
"zu" = (
/obj/machinery/light/directional/west,
/obj/structure/cable{
	icon_state = "1-2"
	},
/obj/item/trash/can,
/turf/open/floor/plating,
/area/ship/engineering)
"Bp" = (
/obj/structure/cable{
	icon_state = "1-2"
	},
/obj/machinery/light/directional/east,
/obj/effect/decal/cleanable/dirt,
/turf/open/floor/plasteel,
/area/ship/engineering)
"CA" = (
/obj/machinery/light/directional/east,
/obj/structure/cable/yellow{
	icon_state = "1-2"
	},
/obj/effect/decal/cleanable/dirt,
/turf/open/floor/plating,
/area/ship/bridge)
"Fq" = (
/obj/structure/cable/yellow{
	icon_state = "1-2"
	},
/obj/effect/decal/cleanable/glass,
/turf/open/floor/plating,
/area/ship/bridge)
"FY" = (
/obj/machinery/power/shuttle/engine/electric{
	dir = 4
	},
/obj/structure/cable{
	icon_state = "0-4"
	},
/turf/open/floor/plating,
/area/ship/engineering)
"Gr" = (
/obj/effect/decal/cleanable/dirt,
/turf/open/floor/plasteel,
/area/ship/engineering)
"Gt" = (
/obj/structure/closet,
/obj/item/areaeditor/shuttle,
/obj/item/clothing/head/welding,
/obj/item/clothing/gloves/color/yellow,
/obj/item/extinguisher,
/obj/item/flashlight,
/obj/item/pen/survival,
/obj/item/storage/cans/sixbeer,
/obj/effect/decal/cleanable/plastic,
/obj/item/storage/box/donkpockets,
/obj/item/storage/box/donkpockets/donkpocketpizza,
/obj/item/reagent_containers/food/drinks/drinkingglass,
/obj/item/reagent_containers/spray/cleaner,
/obj/item/spacecash/bundle/c1000,
/obj/item/spacecash/bundle/c1000,
/obj/machinery/light_switch{
	pixel_y = 23
	},
/turf/open/floor/plasteel/dark,
/area/ship/bridge)
"GR" = (
/turf/closed/wall/r_wall,
/area/ship/engineering)
"Hk" = (
/obj/structure/cable{
	icon_state = "1-2"
	},
/obj/structure/cable{
	icon_state = "1-4"
	},
/obj/effect/decal/cleanable/blood/drip,
/obj/effect/decal/cleanable/confetti,
/turf/open/floor/plating,
/area/ship/engineering)
"Hy" = (
/obj/machinery/holopad/emergency,
/turf/open/floor/plasteel/dark,
/area/ship/bridge)
"HH" = (
/obj/structure/cable{
	icon_state = "1-2"
	},
/obj/effect/decal/cleanable/ash,
/turf/open/floor/plasteel/dark,
/area/ship/bridge)
"Jb" = (
/obj/structure/fans/tiny,
/obj/effect/decal/cleanable/dirt,
/obj/machinery/door/airlock/maintenance_hatch{
	dir = 4
	},
/obj/machinery/door/firedoor,
/turf/open/floor/plating,
/area/ship/engineering)
"Ou" = (
/obj/structure/cable{
	icon_state = "1-2"
	},
/obj/effect/decal/cleanable/blood/drip,
/obj/effect/decal/cleanable/dirt,
/turf/open/floor/plasteel,
/area/ship/engineering)
"OZ" = (
/turf/open/floor/plasteel/dark,
/area/ship/bridge)
"Rc" = (
/obj/structure/chair/comfy/shuttle{
	dir = 4;
	name = "Helm"
	},
/obj/effect/decal/cleanable/blood/old{
	color = "#808080"
	},
/turf/open/floor/plasteel/dark,
/area/ship/bridge)
"So" = (
/obj/structure/cable{
	icon_state = "1-8"
	},
/obj/structure/cable{
	icon_state = "2-8"
	},
/obj/item/trash/semki,
/turf/open/floor/plating,
/area/ship/engineering)
"Ta" = (
/obj/docking_port{
	dwidth = 15;
	dir = 8;
	width = 30;
	height = 15
	},
/turf/template_noop,
/area/template_noop)
"TU" = (
/obj/machinery/power/terminal{
	dir = 8
	},
/obj/structure/cable{
	icon_state = "0-2"
	},
/obj/machinery/light_switch{
	pixel_y = 23
	},
/obj/structure/rack,
/obj/item/extinguisher,
/obj/item/flashlight,
/obj/item/pickaxe/drill,
/obj/item/shovel,
/obj/item/soap,
/obj/effect/decal/cleanable/cobweb/cobweb2,
/obj/item/storage/bag/ore,
/turf/open/floor/plasteel,
/area/ship/engineering)
"UL" = (
/obj/machinery/suit_storage_unit/standard_unit,
/obj/effect/decal/cleanable/dirt,
/turf/open/floor/plasteel/dark,
/area/ship/bridge)
"VL" = (
/obj/structure/cable{
	icon_state = "4-8"
	},
/obj/machinery/door/firedoor,
/obj/machinery/door/airlock/external{
	dir = 4
	},
/turf/open/floor/plasteel,
/area/ship/engineering)
"VO" = (
/obj/machinery/button/door{
	dir = 8;
	id = 1;
	name = "Blast Door Control";
	pixel_x = 25;
	pixel_y = 5
	},
/obj/item/kirbyplants/random,
/obj/effect/decal/cleanable/chem_pile,
/turf/open/floor/plasteel/dark,
/area/ship/bridge)
"VY" = (
/obj/item/kirbyplants/random,
/obj/effect/decal/cleanable/blood/old{
	color = "#808080"
	},
/turf/open/floor/plasteel/dark,
/area/ship/bridge)
"Wp" = (
/obj/machinery/light/directional/west,
/obj/effect/decal/cleanable/cobweb,
/obj/structure/cable{
	icon_state = "1-2"
	},
/obj/item/trash/boritos,
/turf/open/floor/plating,
/area/ship/engineering)
"WS" = (
/obj/machinery/door/firedoor,
/obj/machinery/door/airlock/external{
	dir = 4
	},
/turf/open/floor/plasteel/dark,
/area/ship/bridge)
"YD" = (
/obj/structure/cable{
	icon_state = "1-2"
	},
/obj/machinery/firealarm/directional/east,
/obj/machinery/light/directional/east,
/obj/effect/decal/cleanable/generic,
/turf/open/floor/plasteel,
/area/ship/engineering)
"Zv" = (
/obj/structure/fans/tiny,
/obj/machinery/door/airlock/maintenance_hatch{
	dir = 4
	},
/obj/machinery/door/firedoor,
/turf/open/floor/plating,
/area/ship/engineering)
"ZI" = (
/obj/structure/grille,
/obj/effect/spawner/structure/window/reinforced,
/obj/machinery/door/poddoor{
	name = "Blast Door";
	dir = 4
	},
/obj/docking_port/mobile{
	dir = 4;
	launch_status = 0;
	preferred_direction = 4;
	port_direction = 2
	},
/turf/open/floor/plasteel/dark,
/area/ship/bridge)

(1,1,1) = {"
hw
hw
hw
hw
hw
hw
hw
hw
hw
hw
"}
(2,1,1) = {"
hw
GR
hw
GR
Ta
hw
GR
hw
GR
hw
"}
(3,1,1) = {"
hw
GR
FY
GR
Zv
Jb
GR
FY
GR
hw
"}
(4,1,1) = {"
hw
GR
lk
kC
ll
Gr
ll
lk
GR
hw
"}
(5,1,1) = {"
hw
GR
TU
Bp
fC
Ou
YD
hO
GR
hw
"}
(6,1,1) = {"
hw
GR
GR
GR
VL
fY
GR
GR
GR
hw
"}
(7,1,1) = {"
hw
GR
pn
Wp
So
Hk
zu
qt
GR
hw
"}
(8,1,1) = {"
hw
pz
xO
vw
Fq
uk
CA
bd
pz
hw
"}
(9,1,1) = {"
hw
pz
pz
pz
WS
wd
pz
pz
pz
hw
"}
(10,1,1) = {"
hw
pz
oR
HH
fg
jd
dJ
qR
pz
hw
"}
(11,1,1) = {"
hw
pz
Gt
eE
Rc
Hy
OZ
UL
pz
hw
"}
(12,1,1) = {"
hw
pz
je
VO
dB
ut
VY
tK
pz
hw
"}
(13,1,1) = {"
hw
pz
pz
pz
ZI
cl
pz
pz
pz
hw
"}
(14,1,1) = {"
hw
pz
hw
hw
hw
hw
hw
hw
pz
hw
"}
(15,1,1) = {"
hw
hw
hw
hw
hw
hw
hw
hw
hw
hw
"}
