//MAP CONVERTED BY dmm2tgm.py THIS HEADER COMMENT PREVENTS RECONVERSION, DO NOT REMOVE
"a" = (
/obj/structure/window/reinforced{
	dir = 1
	},
/obj/machinery/computer/cryopod{
	pixel_y = 8
	},
/obj/machinery/cryopod{
	dir = 1
	},
/obj/item/stack/sheet/mineral/diamond/five,
/obj/structure/fans/tiny,
/obj/structure/cable{
	icon_state = "0-8"
	},
/obj/structure/cable{
	icon_state = "0-4"
	},
/obj/structure/window/reinforced,
/obj/machinery/power/port_gen/pacman/mrs,
/obj/item/gun/ballistic/automatic/assualt/ak47,
/obj/item/gun/ballistic/automatic/assualt/ak47,
/obj/machinery/atmospherics/components/unary/vent_scrubber/on{
	dir = 8
	},
/turf/open/floor/mineral/plastitanium/red,
/area/ship/storage)
"b" = (
/obj/structure/window/reinforced{
	dir = 1
	},
/obj/structure/window/reinforced{
	dir = 4
	},
/obj/machinery/computer/helm{
	density = 0;
	dir = 8;
	pixel_x = 5
	},
/obj/machinery/power/apc/auto_name,
/obj/structure/cable{
	icon_state = "0-8"
	},
/obj/item/storage/firstaid/brute,
/obj/item/storage/firstaid/regular,
/obj/item/storage/firstaid/regular,
/obj/item/clothing/suit/space/hardsuit/cybersun,
/obj/item/clothing/suit/space/hardsuit/cybersun,
/obj/item/storage/toolbox/mechanical,
/obj/item/tank/internals/oxygen,
/obj/item/tank/internals/oxygen,
/obj/item/mining_scanner,
/obj/item/mining_scanner,
/obj/item/pickaxe,
/obj/item/pickaxe,
/obj/item/storage/bag/ore,
/obj/item/storage/bag/ore,
/obj/item/ammo_box/magazine/ak47,
/obj/item/ammo_box/magazine/ak47,
/obj/item/ammo_box/magazine/ak47,
/obj/item/ammo_box/magazine/ak47,
/obj/item/areaeditor/shuttle,
/obj/machinery/door/window,
/obj/machinery/airalarm/directional/south{
	pixel_y = -4
	},
/obj/docking_port/mobile{
	can_move_docking_ports = 1;
	name = null;
	port_direction = 8;
	preferred_direction = 4;
	dir = 2
	},
/turf/open/floor/mineral/plastitanium/red,
/area/ship/storage)
"y" = (
/obj/structure/window/reinforced{
	dir = 3
	},
/obj/structure/window/reinforced{
	dir = 1
	},
/obj/machinery/power/shuttle/engine/electric{
	dir = 4
	},
/obj/structure/cable{
	icon_state = "0-4"
	},
/obj/structure/window/reinforced{
	dir = 4
	},
/obj/machinery/atmospherics/components/unary/outlet_injector/on{
	dir = 4
	},
/turf/open/floor/mineral/plastitanium/red,
/area/ship/storage)

(1,1,1) = {"
y
"}
(2,1,1) = {"
a
"}
(3,1,1) = {"
b
"}
