//MAP CONVERTED BY dmm2tgm.py THIS HEADER COMMENT PREVENTS RECONVERSION, DO NOT REMOVE
"aL" = (
/obj/structure/cable{
	icon_state = "0-2"
	},
/obj/structure/cable{
	icon_state = "2-8"
	},
/obj/machinery/power/port_gen/pacman/super,
/turf/open/floor/plasteel,
/area/ship/engineering/engine)
"bd" = (
/obj/machinery/airalarm/directional/north,
/obj/machinery/cryopod{
	dir = 4
	},
/obj/machinery/atmospherics/components/unary/vent_pump/on/layer2,
/turf/open/floor/plasteel,
/area/ship/security/armory)
"bR" = (
/obj/machinery/suit_storage_unit/inherit,
/obj/item/clothing/suit/armor/vest/marine/heavy,
/obj/item/tank/internals/oxygen,
/obj/item/clothing/mask/gas/sechailer,
/obj/item/clothing/head/helmet/marine,
/turf/open/floor/plasteel,
/area/ship/security/armory)
"ce" = (
/obj/machinery/suit_storage_unit/inherit,
/obj/item/clothing/suit/armor/vest/marine/medium,
/obj/item/tank/internals/oxygen,
/obj/item/clothing/mask/gas/sechailer,
/obj/item/clothing/head/helmet/marine,
/turf/open/floor/plasteel,
/area/ship/security/armory)
"cl" = (
/obj/structure/cable{
	icon_state = "1-2"
	},
/obj/machinery/light_switch{
	dir = 4;
	pixel_x = 25;
	pixel_y = 5
	},
/obj/machinery/atmospherics/pipe/simple/supply/hidden/layer2,
/obj/machinery/atmospherics/pipe/simple/scrubbers/hidden/layer4,
/turf/open/floor/plasteel,
/area/ship/crew)
"dv" = (
/obj/machinery/fax{
	density = 0
	},
/obj/structure/table/reinforced,
/turf/open/floor/plasteel,
/area/ship/bridge)
"eV" = (
/obj/structure/cable{
	icon_state = "0-8"
	},
/obj/machinery/power/smes/engineering,
/turf/open/floor/plasteel,
/area/ship/engineering/engine)
"hW" = (
/obj/structure/cable{
	icon_state = "2-4"
	},
/obj/structure/cable{
	icon_state = "4-8"
	},
/obj/machinery/light_switch{
	dir = 8;
	pixel_x = 32;
	pixel_y = -23
	},
/obj/machinery/atmospherics/pipe/simple/supply/hidden/layer2{
	dir = 5
	},
/turf/open/floor/plasteel,
/area/ship/engineering/engine)
"ii" = (
/obj/structure/cable{
	icon_state = "1-4"
	},
/obj/structure/cable{
	icon_state = "1-8"
	},
/obj/machinery/atmospherics/pipe/simple/supply/hidden/layer2{
	dir = 9
	},
/turf/open/floor/plasteel,
/area/ship/engineering/engine)
"kl" = (
/obj/structure/rack,
/obj/item/storage/toolbox/electrical,
/obj/item/storage/toolbox/mechanical{
	pixel_y = 5
	},
/obj/item/multitool,
/obj/item/construction/rcd/combat,
/obj/machinery/atmospherics/components/binary/pump/on/layer2{
	icon_state = "pump_on_map-2";
	dir = 1
	},
/obj/item/pickaxe,
/obj/item/pickaxe,
/turf/open/floor/plasteel,
/area/ship/engineering/engine)
"lK" = (
/obj/structure/cable{
	icon_state = "0-4"
	},
/obj/machinery/power/port_gen/pacman,
/obj/machinery/atmospherics/components/unary/vent_pump/on/layer2,
/turf/open/floor/plasteel,
/area/ship/engineering/engine)
"mu" = (
/obj/machinery/computer/helm,
/turf/open/floor/plasteel,
/area/ship/bridge)
"mv" = (
/turf/template_noop,
/area/template_noop)
"nn" = (
/obj/structure/rack,
/obj/item/reagent_containers/food/drinks/waterbottle/large,
/obj/item/reagent_containers/food/drinks/waterbottle/large,
/obj/item/reagent_containers/food/drinks/waterbottle/large,
/obj/item/reagent_containers/food/drinks/waterbottle/large,
/obj/item/reagent_containers/food/drinks/waterbottle/large,
/obj/item/reagent_containers/food/snacks/rationpack,
/obj/item/reagent_containers/food/snacks/rationpack,
/obj/item/reagent_containers/food/snacks/rationpack,
/obj/item/reagent_containers/food/snacks/rationpack,
/obj/item/reagent_containers/food/snacks/rationpack,
/turf/open/floor/plasteel,
/area/ship/crew)
"oA" = (
/obj/structure/cable{
	icon_state = "4-8"
	},
/obj/machinery/atmospherics/pipe/manifold/supply/hidden/layer2{
	dir = 4
	},
/obj/machinery/atmospherics/components/unary/vent_scrubber/on/layer4{
	dir = 8
	},
/turf/open/floor/plasteel,
/area/ship/engineering/engine)
"rA" = (
/obj/machinery/atmospherics/pipe/simple/supply/hidden/layer2{
	dir = 5
	},
/obj/machinery/atmospherics/pipe/simple/scrubbers/hidden/layer4{
	dir = 4
	},
/turf/open/floor/plasteel,
/area/ship/security/armory)
"rN" = (
/obj/structure/cable{
	icon_state = "2-8"
	},
/obj/structure/cable{
	icon_state = "1-2"
	},
/obj/item/stack/medical/suture/medicated,
/obj/item/stack/medical/suture/medicated,
/obj/item/stack/medical/suture/medicated,
/obj/item/storage/box/hug/medical,
/obj/item/storage/firstaid/medical,
/obj/machinery/atmospherics/pipe/manifold/supply/hidden/layer2{
	dir = 4
	},
/obj/machinery/atmospherics/pipe/manifold/scrubbers/hidden/layer4{
	dir = 4
	},
/obj/structure/closet/wall/white{
	pixel_y = -1;
	pixel_x = 32
	},
/obj/item/storage/firstaid/brute,
/obj/item/storage/firstaid/fire,
/turf/open/floor/plasteel,
/area/ship/crew)
"sj" = (
/obj/machinery/power/apc/auto_name/directional/north{
	dir = 2;
	pixel_y = -30
	},
/obj/structure/cable{
	icon_state = "0-8"
	},
/obj/machinery/atmospherics/pipe/simple/supply/hidden/layer2{
	dir = 9
	},
/obj/machinery/atmospherics/components/unary/vent_scrubber/on/layer4{
	dir = 8
	},
/turf/open/floor/plasteel,
/area/ship/bridge)
"sE" = (
/obj/machinery/atmospherics/pipe/layer_manifold/visible,
/turf/closed/wall/mineral/plastitanium,
/area/ship/crew)
"tY" = (
/obj/machinery/advanced_airlock_controller{
	pixel_y = 25
	},
/obj/machinery/atmospherics/components/binary/dp_vent_pump{
	dir = 1
	},
/turf/open/floor/plating,
/area/ship/crew)
"ub" = (
/obj/structure/cable{
	icon_state = "2-8"
	},
/obj/structure/cable{
	icon_state = "4-8"
	},
/turf/open/floor/plasteel,
/area/ship/engineering/engine)
"uJ" = (
/obj/structure/cable{
	icon_state = "1-2"
	},
/obj/machinery/firealarm/directional/south{
	dir = 8;
	pixel_y = -7;
	pixel_x = 11
	},
/obj/machinery/atmospherics/pipe/simple/supply/hidden/layer2{
	dir = 10
	},
/obj/machinery/atmospherics/pipe/manifold/scrubbers/hidden/layer4{
	dir = 4
	},
/turf/open/floor/plasteel,
/area/ship/security/armory)
"vB" = (
/obj/effect/turf_decal/industrial/warning{
	dir = 10
	},
/turf/open/floor/plating,
/area/ship/external/dark)
"vG" = (
/obj/machinery/power/terminal,
/obj/structure/cable{
	icon_state = "0-8"
	},
/obj/machinery/firealarm/directional/east,
/turf/open/floor/plasteel,
/area/ship/engineering/engine)
"vM" = (
/obj/machinery/light/directional/north{
	pixel_y = 3;
	dir = 8;
	pixel_x = -26
	},
/obj/item/ammo_box/magazine/m10mm,
/obj/item/gun/ballistic/automatic/pistol,
/obj/item/gun/ballistic/rocketlauncher/unrestricted,
/obj/item/ammo_casing/caseless/rocket/hedp,
/obj/item/ammo_casing/caseless/rocket,
/obj/item/ammo_casing/caseless/rocket,
/obj/structure/closet/wall{
	pixel_y = -29;
	dir = 4
	},
/obj/structure/chair/comfy/shuttle{
	dir = 1
	},
/obj/machinery/atmospherics/pipe/manifold/scrubbers/hidden/layer4{
	dir = 1
	},
/obj/item/storage/belt/military/minutemen,
/obj/item/storage/belt/military/assault,
/obj/item/kitchen/knife/combat/survival,
/turf/open/floor/plasteel,
/area/ship/security/armory)
"wt" = (
/obj/item/ammo_box/magazine/m10mm,
/obj/item/gun/ballistic/automatic/pistol,
/obj/item/ammo_box/magazine/smgm9mm,
/obj/item/gun/ballistic/automatic/smg/vector,
/obj/structure/closet/wall{
	pixel_y = -29;
	dir = 4
	},
/obj/structure/chair/comfy/shuttle{
	dir = 1
	},
/obj/machinery/atmospherics/pipe/simple/scrubbers/hidden/layer4{
	dir = 4
	},
/obj/item/storage/belt/military/minutemen,
/obj/item/storage/belt/military/assault,
/obj/item/kitchen/knife/combat/survival,
/turf/open/floor/plasteel,
/area/ship/security/armory)
"wY" = (
/turf/closed/wall/mineral/plastitanium,
/area/ship/crew)
"ym" = (
/obj/machinery/airalarm/directional/north,
/obj/machinery/atmospherics/pipe/simple/supply/hidden/layer2{
	dir = 5
	},
/turf/open/floor/plasteel,
/area/ship/crew)
"zi" = (
/obj/structure/cable{
	icon_state = "1-2"
	},
/turf/closed/wall/mineral/plastitanium,
/area/ship/crew)
"AL" = (
/obj/machinery/computer/cargo/express,
/turf/open/floor/plasteel,
/area/ship/bridge)
"AV" = (
/obj/machinery/firealarm/directional/south,
/obj/machinery/atmospherics/components/unary/vent_pump/on/layer2{
	dir = 4
	},
/turf/open/floor/plasteel,
/area/ship/crew)
"AZ" = (
/obj/machinery/door/airlock/maintenance_hatch{
	dir = 4
	},
/obj/structure/cable{
	icon_state = "4-8"
	},
/obj/machinery/atmospherics/pipe/simple/supply/hidden/layer2{
	dir = 4
	},
/obj/machinery/atmospherics/pipe/simple/scrubbers/hidden/layer4{
	dir = 4
	},
/turf/open/floor/plasteel,
/area/ship/crew)
"BO" = (
/obj/machinery/light_switch{
	dir = 4;
	pixel_x = -8;
	pixel_y = 10
	},
/turf/closed/wall/mineral/plastitanium,
/area/ship/security/armory)
"DB" = (
/obj/machinery/light/directional/north{
	pixel_x = 32;
	dir = 2;
	pixel_y = 5
	},
/turf/closed/wall/mineral/plastitanium,
/area/ship/crew)
"En" = (
/obj/machinery/door/airlock/external{
	dir = 4
	},
/obj/docking_port/mobile{
	dir = 2
	},
/turf/open/floor/plating,
/area/ship/crew)
"EH" = (
/obj/structure/cable{
	icon_state = "2-4"
	},
/obj/structure/cable{
	icon_state = "1-2"
	},
/obj/machinery/atmospherics/pipe/layer_manifold/visible{
	hide = 1
	},
/turf/open/floor/plasteel,
/area/ship/engineering/engine)
"Fq" = (
/obj/machinery/power/shuttle/engine/electric{
	dir = 1
	},
/obj/structure/cable{
	icon_state = "0-1"
	},
/turf/open/floor/plating,
/area/ship/engineering/engine)
"Fw" = (
/obj/machinery/power/smes/shuttle/precharged{
	dir = 1
	},
/obj/machinery/door/window/eastright{
	dir = 1
	},
/obj/structure/window/reinforced/spawner/west,
/obj/structure/window/reinforced/spawner/west{
	dir = 3
	},
/obj/structure/cable{
	icon_state = "0-2"
	},
/turf/open/floor/plating,
/area/ship/engineering/engine)
"FF" = (
/obj/machinery/power/smes/shuttle/precharged{
	dir = 1
	},
/obj/machinery/door/window/eastright{
	dir = 1
	},
/obj/structure/window/reinforced/spawner/west{
	dir = 3
	},
/obj/structure/cable{
	icon_state = "0-2"
	},
/turf/open/floor/plating,
/area/ship/engineering/engine)
"HS" = (
/obj/machinery/power/apc/auto_name/directional/north,
/obj/structure/cable{
	icon_state = "0-2"
	},
/obj/machinery/atmospherics/components/unary/vent_scrubber/on/layer4,
/obj/machinery/computer/cryopod/directional/east,
/turf/open/floor/plasteel,
/area/ship/security/armory)
"HT" = (
/obj/machinery/power/terminal,
/obj/structure/cable{
	icon_state = "0-1"
	},
/obj/machinery/airalarm/directional/east,
/obj/machinery/atmospherics/components/unary/tank/air{
	dir = 8
	},
/turf/open/floor/plasteel,
/area/ship/engineering/engine)
"Ij" = (
/obj/structure/chair/comfy/shuttle{
	dir = 1
	},
/turf/open/floor/plasteel,
/area/ship/bridge)
"IG" = (
/obj/structure/cable{
	icon_state = "2-4"
	},
/obj/machinery/atmospherics/pipe/simple/supply/hidden/layer2{
	dir = 6
	},
/obj/machinery/atmospherics/pipe/simple/scrubbers/hidden/layer4{
	dir = 6
	},
/turf/open/floor/plasteel,
/area/ship/crew)
"IJ" = (
/obj/structure/cable{
	icon_state = "1-4"
	},
/obj/machinery/atmospherics/pipe/manifold/supply/hidden/layer2,
/obj/machinery/atmospherics/pipe/simple/scrubbers/hidden/layer4{
	dir = 5
	},
/turf/open/floor/plasteel,
/area/ship/crew)
"Je" = (
/turf/closed/wall/mineral/plastitanium,
/area/ship/bridge)
"Ju" = (
/obj/structure/sign/poster/minutemen/lanchester,
/turf/closed/wall/mineral/plastitanium,
/area/ship/crew)
"JB" = (
/turf/closed/wall/mineral/plastitanium,
/area/ship/engineering/engine)
"KN" = (
/obj/structure/cable{
	icon_state = "4-8"
	},
/obj/machinery/light/directional/north{
	pixel_x = 33;
	pixel_y = 24
	},
/turf/open/floor/plasteel,
/area/ship/engineering/engine)
"KQ" = (
/obj/structure/cable{
	icon_state = "2-8"
	},
/obj/machinery/atmospherics/pipe/simple/cyan{
	dir = 6
	},
/turf/open/floor/plasteel,
/area/ship/engineering/engine)
"Mn" = (
/obj/machinery/power/terminal,
/obj/structure/cable{
	icon_state = "0-4"
	},
/turf/open/floor/plasteel,
/area/ship/engineering/engine)
"MC" = (
/obj/machinery/power/smes/shuttle/precharged{
	dir = 1
	},
/obj/machinery/door/window/eastright{
	dir = 1
	},
/obj/structure/window/reinforced/spawner/west{
	dir = 4
	},
/obj/structure/window/reinforced/spawner/west{
	dir = 3
	},
/obj/structure/cable{
	icon_state = "0-2"
	},
/turf/open/floor/plating,
/area/ship/engineering/engine)
"MT" = (
/obj/structure/sign/poster/minutemen/gold,
/turf/closed/wall/mineral/plastitanium,
/area/ship/security/armory)
"MY" = (
/obj/structure/cable{
	icon_state = "0-4"
	},
/obj/machinery/power/apc/auto_name/directional/north,
/obj/machinery/atmospherics/pipe/simple/supply/hidden/layer2{
	dir = 4
	},
/obj/machinery/atmospherics/components/unary/vent_scrubber/on/layer4{
	dir = 4
	},
/turf/open/floor/plasteel,
/area/ship/crew)
"MZ" = (
/obj/structure/cable{
	icon_state = "4-8"
	},
/obj/machinery/door/airlock/security/glass{
	dir = 4
	},
/obj/machinery/atmospherics/pipe/simple/supply/hidden/layer2{
	dir = 4
	},
/obj/machinery/atmospherics/pipe/simple/scrubbers/hidden/layer4{
	dir = 4
	},
/turf/open/floor/plasteel,
/area/ship/bridge)
"Ni" = (
/obj/effect/turf_decal/industrial/warning{
	dir = 9
	},
/turf/open/floor/plating,
/area/ship/external/dark)
"NC" = (
/obj/structure/cable{
	icon_state = "2-4"
	},
/obj/structure/cable{
	icon_state = "2-8"
	},
/obj/machinery/power/apc/auto_name/directional/north,
/obj/structure/cable{
	icon_state = "0-4"
	},
/turf/open/floor/plasteel,
/area/ship/engineering/engine)
"OR" = (
/obj/machinery/atmospherics/pipe/layer_manifold/visible,
/turf/closed/wall/mineral/plastitanium,
/area/ship/security/armory)
"Pc" = (
/obj/machinery/airalarm/directional/east,
/turf/open/floor/plasteel,
/area/ship/bridge)
"Ph" = (
/obj/structure/cable{
	icon_state = "4-8"
	},
/obj/structure/cable{
	icon_state = "1-8"
	},
/obj/machinery/atmospherics/pipe/manifold/supply/hidden/layer2,
/obj/machinery/atmospherics/pipe/manifold/scrubbers/hidden/layer4,
/turf/open/floor/plasteel,
/area/ship/crew)
"Pn" = (
/turf/closed/wall/mineral/plastitanium,
/area/ship/security/armory)
"PZ" = (
/obj/machinery/atmospherics/components/unary/vent_pump/on/layer2,
/obj/machinery/light/directional/north{
	pixel_y = 3;
	dir = 8;
	pixel_x = -26
	},
/turf/open/floor/plasteel,
/area/ship/bridge)
"Qw" = (
/obj/machinery/door/airlock/external{
	dir = 4
	},
/turf/open/floor/plating,
/area/ship/crew)
"Re" = (
/obj/machinery/power/terminal,
/obj/structure/cable{
	icon_state = "0-1"
	},
/turf/open/floor/plasteel,
/area/ship/engineering/engine)
"TZ" = (
/obj/machinery/atmospherics/pipe/layer_manifold/visible{
	dir = 4
	},
/turf/closed/wall/mineral/plastitanium,
/area/ship/security/armory)
"Uh" = (
/obj/effect/turf_decal/industrial/warning{
	dir = 8
	},
/obj/machinery/atmospherics/components/unary/outlet_injector/on/layer4{
	dir = 4
	},
/turf/open/floor/plating,
/area/ship/external/dark)
"Up" = (
/obj/effect/turf_decal/industrial/warning{
	dir = 8
	},
/turf/open/floor/plating,
/area/ship/external/dark)
"Ux" = (
/obj/structure/cable{
	icon_state = "1-2"
	},
/obj/machinery/door/airlock/security/glass,
/obj/machinery/atmospherics/pipe/simple/supply/hidden/layer2,
/obj/machinery/atmospherics/pipe/simple/scrubbers/hidden/layer4,
/turf/open/floor/plasteel,
/area/ship/security/armory)
"VK" = (
/obj/effect/spawner/structure/window/reinforced/shutters,
/turf/open/floor/plating,
/area/ship/bridge)
"YM" = (
/obj/machinery/power/smes/shuttle/precharged{
	dir = 1
	},
/obj/machinery/door/window/eastright{
	dir = 1
	},
/obj/structure/window/reinforced/spawner/west,
/obj/structure/window/reinforced/spawner/west{
	dir = 4
	},
/obj/structure/window/reinforced/spawner/west{
	dir = 3
	},
/obj/structure/cable{
	icon_state = "0-2"
	},
/turf/open/floor/plating,
/area/ship/engineering/engine)
"YQ" = (
/obj/machinery/holopad/emergency/command,
/obj/machinery/firealarm/directional/west{
	pixel_y = -4
	},
/obj/machinery/atmospherics/pipe/simple/supply/hidden/layer2,
/obj/machinery/light_switch{
	pixel_x = -21;
	pixel_y = 9
	},
/turf/open/floor/plasteel,
/area/ship/bridge)
"YX" = (
/obj/structure/cable{
	icon_state = "4-8"
	},
/obj/machinery/light/directional/north{
	pixel_x = 33;
	pixel_y = 24
	},
/obj/structure/rack,
/obj/item/stack/sheet/mineral/uranium/five,
/obj/item/stack/sheet/mineral/plasma/fifty,
/turf/open/floor/plasteel,
/area/ship/engineering/engine)

(1,1,1) = {"
mv
mv
mv
mv
mv
mv
mv
mv
mv
mv
mv
mv
mv
"}
(2,1,1) = {"
mv
Ni
Uh
vB
mv
Ni
Up
vB
mv
mv
mv
mv
mv
"}
(3,1,1) = {"
Pn
Pn
TZ
Pn
En
wY
wY
wY
wY
JB
JB
JB
mv
"}
(4,1,1) = {"
Pn
ce
vM
OR
tY
sE
ym
nn
wY
Mn
MC
Fq
mv
"}
(5,1,1) = {"
Pn
bR
wt
Pn
Qw
wY
MY
AV
DB
KN
JB
JB
JB
"}
(6,1,1) = {"
Pn
bd
rA
MT
IG
cl
rN
IJ
Ju
ub
Re
FF
Fq
"}
(7,1,1) = {"
Pn
HS
uJ
Ux
Ph
wY
zi
AZ
wY
NC
Re
YM
Fq
"}
(8,1,1) = {"
Pn
Pn
BO
Pn
MZ
Je
lK
oA
kl
hW
Re
FF
Fq
"}
(9,1,1) = {"
VK
AL
PZ
YQ
sj
Je
YX
KQ
EH
ii
JB
JB
JB
"}
(10,1,1) = {"
VK
mu
Ij
Pc
dv
Je
aL
HT
eV
vG
Fw
Fq
mv
"}
(11,1,1) = {"
Je
VK
VK
Je
Je
Je
JB
JB
JB
JB
JB
JB
mv
"}
(12,1,1) = {"
mv
mv
mv
mv
mv
mv
mv
mv
mv
mv
mv
mv
mv
"}
(13,1,1) = {"
mv
mv
mv
mv
mv
mv
mv
mv
mv
mv
mv
mv
mv
"}
